counter,true_positive,false_positive,true_negative,false_negative,file_count,hexsha
1,1,0,0,0,1,830a52683eae75bba8fec49d6f54fbce412da693
4,2,1,1,0,4,d158cfda9c9b129b661883d636b48cf549ec8933
5,2,1,1,0,4,94f1e03a4fea0b7b1ff97869a85ad063ad551ae3
10,2,3,6,1,12,18894d2f50c8e0ed5b1a8a07ed1574877e828b8a
11,3,3,4,3,13,2329cffb4362ca30366273de1fc193fc45633b76
12,3,3,4,5,15,d2c359198b71a589f7278b450164373e6ad6b6e1
14,3,3,4,5,15,91616a3075811321b00a76118ba87303c8d3e019
17,3,3,6,7,19,249fd95d1f837cb9a694fac03c4325c27b8301a4
20,3,3,7,7,20,035bbed784daeaed3a845a679cfef8d1e0daffdd
23,4,4,17,7,32,cb05c495509ae406b18d17e9fceac8878463132a
24,4,4,17,10,35,292ba42386036c340e24b48c3dec3dee29398dc2
25,4,4,17,10,35,1939efe13f3792116181d8e320107054eebb9799
28,4,5,18,10,37,e2a20c6743f020e5ce5c7fffc3c67915c621fd3b
29,4,5,18,11,38,b49b7ba28e985f5bc0c5a8d2cae7314db192a041
30,5,5,18,11,39,82b79e3e06f215e7bc13a958c956944c1dc45e50
31,5,5,18,11,39,35aa86d0ce7cae8b18922b382c2b6e683698a520
33,6,5,18,11,40,5e2b6b273572c9d066ab83c2e6a0c28ba402640a
38,6,13,74,11,104,d4c6645d29125e86184b6573a76b6c40920e8e7c
40,6,13,74,13,106,c917c78fd100e1d4db5fc5b488410a5741eeb46b
43,7,13,76,14,110,f8514a0d5984230c5044c8bbca67ea283f64a914
44,8,12,76,14,110,0c11983f083d69c0bff2a7a4f6f092618ddfc925
45,8,12,75,15,110,cf3c762bffbc2e86ee91ed2034d0df9deb0c4b11
47,8,12,76,16,112,7dc6e97f2447097a4539e181945cb2a4c421efe5
48,8,12,76,17,113,ded831b5104dcc145da51f9d9126925c5b821912
50,8,14,78,17,117,205fb6c9a5f74b0673c80163270c8269db7822d9
55,8,15,79,19,121,e2b8f02cf8545f61cb950f4a7b333fb4ac7d5ffc
57,8,15,79,20,122,59ad5e21953a6d591f82def11aebd64808ab9559
61,8,18,86,20,132,88b3ef20689a9ceefc06789e1a2e729aeb4aef5d
62,8,18,85,21,132,ca0a07f4b1b4da86e87f1839e48b9eef450f1795
68,8,19,86,28,141,bc126afdb651e50a54ed4ac0f0ca9e6729044d54
72,9,18,86,28,141,a14767c4d14cb43ba66f9c85b414401a49a23060
75,9,18,87,28,142,36f9e01ec1aafc1ba3412f3845a63b91ee73fcde
80,9,18,90,29,146,9bf390cbd5e1d7a9d234921f8b5fdfbac2648075
83,9,18,92,30,149,d4d03cc24361ef865af7990c8169d5032e3fff51
84,10,18,92,30,150,43f01191f23593d01ffe78a19ad44d8dbe051177
87,10,18,92,30,150,b161f611081e9dc4369d53cc12957137fe6a9579
88,10,18,91,31,150,d358ee4254f48031d7109dbba09df363e212523f
90,11,18,91,31,151,ce6adedfba201311b0d6b45ab7c9ec9cd3a5a7c3
91,12,17,91,33,153,e57b7fc31ae237df5439459d602651ed3cc10557
98,12,18,98,35,163,33d82c59d1711cafd9ffddb55e3c3062e2f528cc
104,12,18,104,36,170,a977445fea0feb745166e7c4238cb1853db642f9
107,12,18,105,37,172,45bf3d0683bc3a0b9b87709ee09e39467bf53eb1
110,12,18,108,37,175,31fbd86172befcedb5acaebb5486822a8951a3db
115,12,18,108,37,175,258986e20a5143cdaab25ac1a9173f1648f97ac2
117,12,18,110,38,178,46d1024d618cb2c0652b66c49f16e7d2f0bf3f37
121,12,18,121,38,189,a3300c7b77aa2ad7fe6d4d4889d36029df60fc45
125,12,18,121,39,190,23869f9874236b2094afe5c026cdef1dce4af4a1
126,12,18,119,41,190,6f4d0bb6158491cc2c1d4aa28fa8658e23b2593b
129,12,18,120,42,192,d36a1371c7d5576e49c262332102df25971aca0e
130,12,18,120,43,193,6030ef859c93c6472443e0221bfcdc9c8a3466ce
135,12,18,118,45,193,c269cbe996d28fef383ab7a5dbb0b1ae6b0015af
137,12,18,118,45,193,97b67523e5511498371502db1ef5bc72ee2e4c8f
139,12,19,135,46,212,abd3298ab6408a50fc24b92ca37c3e64fe95af01
141,12,19,135,46,212,7980e0bad3364ef3e183d28cc691e4c0658bda83
146,12,19,137,46,214,523cf41bc9e8b167856d1949fd32dd83b1b49ab4
149,13,18,137,46,214,14f47d34d6881f2c4f213e3408413cd5b21f71c6
150,13,18,136,47,214,c8d8f8812efc716b6f68b46976bee20535567a95
152,13,18,136,48,215,5f435deb450a148c6a4abe882360e15053ad5dd3
154,13,18,136,48,215,8deed4ecbed6b6486478a407b0a24f85e61e9370
157,13,18,137,48,216,ff739c0ac827fcea8fc0e20b3f9eb9cf09858296
160,13,20,141,49,223,ed73d4ff327dea408dd03deb7f957a17e9346896
161,13,20,140,50,223,96fb5a1eee5482b710b0c39db92c675188702206
162,13,20,140,50,223,49ccffed3587ce627ec7aa54af0e0db301848650
163,14,20,140,50,224,ec446e6aeb4c64830395443dcb978724362fbf92
166,14,20,140,50,224,d46dc2741b46a4d9f5efb9500142bd5352a39580
168,14,20,140,50,224,2f855a38a625ec5dcbb8ba59d2d65a4882d27637
180,14,22,142,50,228,5b093d616912d2a9b3a596186bb3044ddb168689
181,14,22,142,51,229,859f03a8e397f01fe8e371a90f59a7f1a86bb3f6
186,14,23,141,52,230,48b9a75d19e8d088e28f2ef27266c147c116627f
190,14,23,140,53,230,a836a0a39330e5e2ecdfd69c11f05dbfafcc7165
191,14,23,140,54,231,d3463b5f9056a54f8af1ede7c645a0a00b7f214c
193,14,23,140,54,231,0dcb8030e97df7945e7bdd021aa2b99d38cd3409
197,14,23,141,54,232,01011d71b77f3d2b68c19bb3bf50d600aa0d38a7
198,14,23,141,54,232,5f4673866159f178776dba1e696dc3134f4bc014
199,14,23,140,55,232,9752747e0766f1ac61180a7c086cf64b8a1ff1c1
200,15,23,140,55,233,5e55dc28b43b635e3fc243dc6f2e5295f73e4e67
201,15,23,140,55,233,90fe9664cf2b6e86d37c745b2f8c9c90b151d4ca
210,15,23,140,56,234,ea17b48c6e99e9d6b021fa04085d4bbdda0bc72a
212,15,23,140,56,234,a2a6a78b97b67c4237189e5db27b7ad7689cf293
230,15,23,140,56,234,e991e296b1b1e0bccc6b49b85e7b3c18aab98aab
235,16,23,140,57,236,5506aba84638f921bc84b125f78d5e1c600d14fb
240,16,23,141,58,238,01b52461353eb6053449457ae3930d07acc08056
241,16,23,141,59,239,9fad1dbc4887380d4cf0f118279387208eda4072
243,16,23,141,59,239,e44f4ab092b8a1294ef7f5089f938d419bd30964
244,16,23,141,59,239,3b10321c9006f2194e769ff0dcd5155ba75eaf31
256,16,24,140,60,240,716fd56f0265c6d8c437488b0abd2448a366c9aa
266,17,24,142,60,243,492813b4d255816038707363a74094e975893325
285,17,24,143,60,244,8f5ef5ae512418fc96213dfdc35a2954cb2ea067
296,17,24,143,61,245,4e66d0e0c8cfdd12e79a9809dada2939b5106154
306,17,24,143,61,245,7d5214e63ebbcfcd1df92a82f40ad7de0f5f76d8
308,17,24,143,61,245,fb5a0dca62fc954060385e6d1b52a73e1670bc72
309,17,24,143,61,245,6b182c8a18189b98f4fda868bce517f4f80c7221
310,17,24,143,61,245,1693a30449ef30d93b3c5d728a2365238645591b
324,17,24,145,63,249,4306729912b2e5fac23e33a1d4605666dd54e03f
326,17,24,145,63,249,0e43f774ddae48e3166ffb94055d884ed2f3b400
329,17,24,144,64,249,cf7ede6acc5109b894a2251ced753984cffff991
333,17,24,144,64,249,6e9f8a7fffad1bced211904d9119ccb8edbbf3ab
341,17,24,146,65,252,4c280ff2811a796373f7daf26414e67f9ab28151
347,17,24,145,66,252,958b7c8fa66ece2a888fbd7ea37914b99c092bce
351,17,24,145,66,252,2f0ef140a89213b234f84d78685edd643503ae30
353,17,24,145,66,252,f75d4ae6e54bc25516010ef6631200b5ca91117f
355,17,24,146,67,254,fe324e5c151a854e1e87a74814af678e22f81a17
356,17,24,145,68,254,075ad7237c9cef914add8a060ded6fe578ceeaee
357,17,24,144,71,256,6535fb49c0449d0e33ecfaa0f6faa6fedb1f3eea
358,17,24,144,71,256,82f6c3af24d2b17f4ea174ad0e3d639c6774ff5a
364,17,24,145,71,257,6949db379e27d8729e7f9c5cc1d3c793934cc9fc
366,17,24,145,71,257,2aaa0cad1a3c507450a994f3ebefb78a84c45fbf
367,18,24,145,71,258,5b29543a1aa3eb978ae91df509ee7308b9ffd048
368,18,24,145,71,258,8ccd2de55062db876b75ea144b75307e7aff7519
383,18,25,149,71,263,39c56dab8c3146a48d38994f658e23bdd1d60cd6
407,18,26,153,71,268,b98fcd20897f4dee5c3fddad26ba83a2cc6a2944
411,18,26,153,72,269,5645b4f09fecb4ddaf9ac84fb367539cf85e3376
412,18,26,152,73,269,aea86a1b7a1c4b36adc0e8b201f6a40666abd2ca
413,18,26,152,74,270,c59cf065fa27a1df79434c25a768edb7b7c6dda6
414,18,26,151,76,271,d6b6bd4de9c82df6350914f0efb1cb14301011d4
415,18,26,151,77,272,53be601f35e7bccd699439b3356bd37f49ab1933
416,18,26,151,77,272,787f5cb54b9d50de3c3272d4c899bb7686e31981
419,18,26,151,78,273,d562d17235fec217add9daf5733e5a3bf86410cf
421,18,27,150,79,274,d998021db61ad568e2a7469a22b10837896165b3
434,19,29,160,81,289,c339e921be4bf2f464c29e8fc5d94ef5cfb1b87e
435,19,29,159,82,289,e21950bf80e24908da09ae198ff453cccda2d005
441,19,29,159,82,289,059f525b8731556f4878cc46a7712f7c92f91940
442,19,29,159,82,289,0cab35ba9c80839c256ea6804365f5bf4804a25d
