counter,true_positive,false_positive,true_negative,false_negative,file_count,hexsha
2,2,0,1,0,3,4e8b167e4d0817b6ae93be8ad97b31bf203698d8
3,5,0,1,1,7,08572e8d125da204fab230be5d1fdcc5d8d22256
4,5,0,1,2,8,fea45eff5a2f2ad10b2788603db80e5a4fe6be06
5,5,0,1,3,9,80be597a7b2530ec0893e1d9ee8275e281f026dc
6,5,0,1,3,9,8ca35d7c6a639933927f45b439363a1614da56f1
7,9,0,1,4,14,358850781f8fd3d79aba5b1a9a0b8d28f544bf8a
8,10,0,1,4,15,a40a34a4b2d79dbf798df538c26222148d42b17c
9,10,0,1,5,16,6b28e957df364532109a1897c73a1fa8b1416bd4
11,15,0,2,5,22,70123cf084e3af7dfc61bb7bd2090ff802c3cda4
12,17,0,2,5,24,a9e29fae105d1ddd4e0ac2059cbe62b0ee348bc8
14,17,1,2,6,26,36a17be9f3cf6081f7e6f83fcfeae3d09ce8a72b
16,51,2,2,40,95,39a7eed1bbf12020a077e4bec3d82e08f171a021
17,52,2,2,40,96,767c33d1fa9827908192e8ed1ac7f281f56bd811
18,56,2,2,40,100,8714403614c4dfa37e806db4a6708b8a91a827a4
20,58,2,2,48,110,d61ebc8fed212366340b1ed6f5d7722613801459
21,58,2,2,49,111,9a4a9a8a49ed3e38f3038b8d6fc7c405256271f1
22,58,2,2,49,111,fb7d681705a92c6d510b06822450d6a94ed1623f
24,63,2,3,50,118,668d53cd125175eb708cc0af143f47b42cd42153
25,63,2,3,50,118,82f7bee1d56e1bf8ae041c6cdeb7374ea6b844de
26,65,2,3,50,120,ceaf31adfff3801f1092a215f73704e15a70e90c
27,65,2,3,52,122,ec808e807ad711b993f199f6b4165ac6d0e1125b
28,66,2,3,53,124,88c605e3e34cebd5485d286a17ac84c7b8b0faf1
29,69,2,3,54,128,c36b60836be9e78ab877566cc43dc03960ce944d
30,71,2,3,54,130,f4f0060feaee6bbd76a0d575487682bc541111e4
33,72,3,3,55,133,87d78241a2fc85e5715fb51c554fe06e91deee58
35,72,4,8,55,139,866e71140f9612e45087b8acafefa2e51ffc4a29
36,74,4,8,55,141,888c9b6429a44824078a49fb1ebacf2e950cd887
37,75,4,8,56,143,a5b225084f69e27b78fab0f2954fa9520656976e
38,76,4,8,57,145,336512fae77ec214ad6db24166b9a8676007cc09
39,76,4,8,58,146,794c3f74c32062d0f2ad021cb2af0e530b40730d
40,80,4,8,58,150,e272904ff7cc4d138e316ba2e7811666053860a4
41,80,4,7,59,150,eb9b7abb833a6d317e355265552d47e0d8f24af8
43,82,5,7,60,154,fb146193c49e4c683dc8da39d9b7c479375fdb57
44,85,4,7,66,162,fa350e2f303572ee8f9a8302dda45a12288d3d95
46,87,4,7,66,164,82c9169077a066995e3b00aac551bf1c8a89d98a
48,89,5,7,66,167,df193b3cefda982dfcd4813bf4e2ac09b1358f21
50,89,6,7,66,168,756cee46d25a52108fd7190f787a7e636962df5d
51,90,6,7,66,169,b9b8411129efe13642cef1fc6bbfc62bed717352
54,92,7,7,68,174,f66c2bdc0f056ffcbf6df121ea9132aaa0c4cadb
58,92,7,10,68,177,7b1a67cce52e5c191fbfa1bca501c6f0222db019
59,92,7,10,68,177,3ed9c7bdfe9f40d31dadb6734a5692c8b9d6d6dc
62,92,10,10,69,181,a3e89f13dfb1f22a26ead8b06b37695598a4421a
63,93,10,10,69,182,ccff08c194b0b7f8a86bf9c5dd6d5be473760a1b
64,93,10,10,69,182,389baccac5fce72c67cfed7a6ebcf9273edf9282
67,94,11,10,69,184,28e8c54d7d2800a8ac98cf646a9e074055bc1b1b
68,95,11,10,70,186,8a481498aa995b435d8c3a0c90d7d917046f59b3
70,97,11,11,71,190,f0f5212624d7a3edbf77126e0a3060d38db501e1
71,97,11,11,72,191,b4d8b16e5109170614ba505e36f60c2ad64dafc2
72,97,11,11,72,191,e4a578e70e2e48ab792e38c67579808a1def6024
73,97,11,11,72,191,c9f1a12925ef18d82b5f9683d589bb2c1e067650
76,97,11,11,72,191,a535e4acdcf1e75cc4d6302726876efc4c3a91c9
78,98,11,11,73,193,d861f95c445652e4269c9015836d14dcf8b9a587
81,98,11,11,73,193,f6b09a7f85c3b67b2011553838b079788c413432
83,102,11,11,75,199,aa5ab114e34645823b219f9a866fd82fc26b427b
84,102,11,11,76,200,d8de9a64d70f4bef7a223da1559638699a7a3923
85,104,11,11,76,202,5993b52e6d9db00259fd5a186b3c3df767fe94e2
86,105,11,11,76,203,b089759d6025582f36fbea3c4be3855c50b82462
87,106,11,11,76,204,e8a758e941bb36f69b6224b73b00b9d6a814bbdc
88,106,11,11,76,204,b9d9ab23bdcc404708aada664e718a9d56415ca3
90,109,13,11,76,209,34fb909180e9df06fa6a993dd5696a49cd152a0b
91,109,13,11,79,212,21ffbb06ec9eb741f62ac51abab4b722fb91b9bc
92,110,13,11,79,213,ae87ad005f7b62f5fa5a29ef07443fa1bbb9baf0
93,111,12,11,79,213,8414fcf16b9cfa8d989db913f0961fc4ce18c71b
96,114,14,11,80,219,28986da4ca167ae257abcaf7caea230eca2bcd80
98,115,15,11,80,221,820381d38bc02ea8b92837ce869e7332a7db9913
99,117,15,11,80,223,0ed20d5cc4bf94646ffd4e4fcbd963b9916039cd
101,120,14,11,80,225,388e79e9fcbf689d5708134534e55d176cfbcee3
102,122,14,11,80,227,818182b514d1c6b379130c440689355b4d231d49
103,122,14,11,80,227,8758a63ddbbf7a2626bd84d50cfe83b477e8de0a
104,126,14,10,83,233,f269c1d6f6dcc22c0a781f3223c6da0a4483b06e
105,126,14,10,83,233,b9cb81570e24284156e09ab1fdc3c19a8d563b07
106,130,14,10,83,237,81c2d9f60b9206c1291e5b1c3c8686f24a7726e1
107,130,14,10,83,237,ff2aa4019259947734c4791d6afc9f5405d901d0
108,133,14,10,83,240,88d798d71a20662bdf5335f0586fb9eb6e660c57
109,133,14,10,83,240,71c638fc55d5b0637e0c50a71694f3e422caa0c1
111,134,13,11,83,241,c5c8751147d41913a05e86097ea29ccc9fc2e5be
116,135,14,163,84,396,6bff3439894ac22d80f270f36513fc86586273f3
117,136,14,163,85,398,0339844b70895d6162b4595ae615e6edf843c6cd
118,145,14,163,88,410,a0c2eb46dd5a782c11c44f13c8efad2778be1641
119,145,14,163,89,411,b4a56ed4f55502239cb11b57f0fa75baa0a97640
120,151,14,163,90,418,65129aac07022f23afa1df7ec7fad2216634cb38
121,151,14,163,90,418,02d78bb1a80706d941ffc6c892cc75208eb6b782
122,155,14,163,93,425,81e1a35c364e5353d2bf99368ad30a4184fbb653
124,156,14,163,93,426,1c83fc88d6928a5ab53bc3dde79dad3cc0bfcfdc
125,158,14,163,93,428,011a54315e46acdf288003566b8570440f5ac985
128,158,14,163,93,428,35b3158d52a5fe51d3b52aec1109a30a73c5abe9
129,159,14,163,93,429,eb5ebcc2d0b13737127e3478bced98a84962a5d0
130,167,14,163,93,437,55f12f8709f0604df7e1817a4c114ead1fb9a311
131,168,13,163,93,437,d898ba1bec588450d591ebd5076993f96d05eb24
132,168,13,163,93,437,8219eabbba6e8f6d8569792615935011b5cf0771
135,168,13,163,93,437,0d9b018e07c384314e142372153eb670c2e129f3
137,168,13,163,94,438,556eb6770146f26a7f01f786034d8b3ec879ed05
138,168,13,163,94,438,6bb2175ed65456dda2f8ba584f206ba4bbd43dbc
140,168,13,163,95,439,6770b7ecd208a0746f181e54202fb829460c6490
142,168,13,163,95,439,aea02ddfb7c610db9a7cb291b113d6e561d8eba9
143,168,13,163,95,439,9e83f30cd318693995decebdc68433853e93a6bb
148,171,14,163,95,443,966a29c2b83fed2fc7c2b5b09de80cbebc94ac74
149,172,14,163,95,444,53c2cf1e7b3f1c9a7794fcc5c4669145f351b2fa
151,176,14,163,95,448,a6bada1ee0c3756e4b8d6bd4b4346dd5235c78ce
152,176,14,163,95,448,127b3873d03704f77428b984de022664b268314e
153,176,14,163,96,449,02a2943e4cf95dea0294e8695cfe981f34ae6180
154,177,14,163,96,450,82ec05fcc96121d7b23cc07c2c0ad3c0546bac35
155,177,14,163,97,451,87fed9444033533ad7105c4b1e4ffc5d7854a2c6
157,178,14,163,98,453,23a5d64f40b0f4a3fbfef7427ca793cb1df1034e
158,178,14,163,98,453,74f8110e74927c231bfcd106fa28bf6e6dd034e6
159,178,14,163,99,454,b4382b7055fc8b0078cbb50ed9c3f924635d9971
160,178,14,163,99,454,a4a58811b9729ed1ab2417d72e5d07ebb1a30886
161,179,14,163,99,455,00e667728ba3ef1b5cb3de0e11c7648b89315a91
162,181,14,163,99,457,1aadade373336c3f534986cdcc0ba33714d85c8e
163,181,14,163,99,457,b4da88b1268668c11dd999a7a0915193c204bf04
164,182,13,163,99,457,01ec127baec38b7f8281e6eca9def40f22c9e5ad
167,182,13,164,99,458,fca14cd3f27a01f7ba1fe32ea9587fa75b85713a
168,183,13,164,99,459,118cae2df8c89b63a2dcecab0728e6199f101fa1
169,186,13,164,99,462,80e3444eca045799cc40e50c92609e852a299d38
170,187,13,164,101,465,0decef337f7f00d73b380531ac22cbc843d6e806
171,187,13,164,102,466,c633667da3605208ea5fc137f5322c599f48da69
172,188,13,164,102,467,8654c6a7329c06133b6c4b32f05e606132a338e5
173,190,13,164,102,469,b68212f539f206679580afbfd008e7d329c9cd31
177,190,40,170,107,507,cb506aed2a3ca439a7ed6cff410667f302405c8b
178,191,40,170,108,509,cda74c7fc99abe1848e1f4965070108dd2ae378a
180,193,40,170,108,511,720ff740e70e649a97fcf0232fec132569a52c7e
182,196,40,170,108,514,e2bfcab065fef4f1c2f32195c74f054991c33151
184,198,40,170,109,517,3e64f3d0fc285080b42b78b67565b6ed939f9a24
185,199,40,170,109,518,9128762f1608f9633005f16c95270058a50ada2b
187,202,39,170,110,521,4ee08958f154594b538207a53c1d457687b3f7ae
188,202,39,170,110,521,98c5370ef673bc83deaf24c197e0bb22a75071e3
189,203,38,170,110,521,2acf9d099d29f45c829ee0127e55b7cfdd201995
191,203,38,169,111,521,dc5b01ad05e50ccde688c73c2ed3334a956076b0
192,211,38,169,112,530,1f2abf784a9fe550959de242d91963b2ad6f7e9c
193,211,38,169,112,530,c2bfd76ec3678cc28fb6fce6be0ae217b46bcd9e
196,211,38,169,112,530,6de3a1e2c34ae5bfcdec3ebbf3d682aa578ecae0
198,211,38,169,112,530,c7ec3c07e78e288a48e87b979dbd12e1fa44fe66
199,213,38,169,112,532,bc83add04c06e601d09a60df5492ff794baa2cbf
200,213,38,169,112,532,75430be86f4c90b7fb8a370d2b080a8a7cc925a0
201,214,38,169,112,533,8119876d4a533fbc2ba4d1c30eaddbcc28119488
202,216,37,169,114,536,dc27f3ee0c3eb9bb17d6cb764788eeaf73a371d7
203,219,37,169,114,539,c5cc332bf2a0b3ebfa3ad5d26c5b308de5e505be
204,219,37,169,115,540,931a340f1feca05b7a9f95efb9a3ba62b93b37f9
205,222,37,169,115,543,e4cf8c8420634d6f2dc8ce873246256ce635972d
206,224,37,169,115,545,b86abbceb9a96d7a0fe18047c8fcd6fca90a2f3e
207,224,37,169,116,546,845817b039fc059955bb1eafa5fd78565a49159d
210,224,38,170,116,548,4e59156c10d36eeb1e6fced4dff0f11157f68264
211,225,38,170,116,549,57dc8dd3fa3c3adf133c522ecadb501d94bacd52
212,225,38,170,116,549,3e7d9d05ac5efff4e4732c3453c7a8ef502d0ed0
215,227,38,170,116,551,4ea1909d3c420ba1fbdbf7221cad518d43aef885
216,229,38,170,116,553,0808ccce3808235c5b5a56e3f689cec0d4bc0ebf
217,229,38,170,116,553,a184a99123e4dc4c2a90c20e1604e5d301cd76bf
222,229,40,1868,116,2253,3f4e77840249c533b08ef9f1d03d7e3387ed2b4c
231,229,40,1868,116,2253,8f987323791181783d3f1ba847ffc0a938ddccdf
233,229,42,1868,116,2255,30a3c2f74c030449d3a8b9f02ab6744874712e54
235,232,41,1868,117,2258,5bc3123479bd97dc9d8a36fa9a3421a71063d1da
240,232,41,1869,118,2260,1119063c69eb4fc091c212e59462f3ec3d5676a4
241,233,41,1869,119,2262,426b63ba04521b8eaffb129b7e4feca36eed8777
242,233,41,1869,119,2262,7a0d9b5cda04c74287e052f1b4ebdf869e53ff0f
246,234,41,1871,119,2265,d597174bd4cfd9a0e1b34dae8b4d8d027a8cab72
247,234,41,1871,119,2265,e8e4f978dd4b7a3d0c689c6e3301e3c6f9e50003
248,234,41,1871,120,2266,ad53213066ad25545959170f40322fa5b094989b
249,236,40,1871,120,2267,2cf58e80d1be46ae95f77c95fe014921742295dd
252,236,40,1872,120,2268,0385dad073270c37f8c4a5f13edce43f2a69ba8a
254,236,40,1872,122,2270,e37d52bd5eb98e6ddf61b766720583481d18bc2b
255,236,40,1872,122,2270,981e3b9394022810bd536474344e2f91c190b858
257,236,40,1872,122,2270,2fc19b92387d4248c715edfbf38658238978abb6
258,236,40,1872,122,2270,3acefcefeb5283473ac35d7e842027814d57d574
259,237,39,1872,122,2270,6d7784a7b994eb8287ec851b22acb5170e77a90a
261,242,36,1872,122,2272,72f769f494822981db6df9524b92a2d86f8e69fe
262,242,36,1872,122,2272,1273a7a0e808a43ce7a344bbf36d55b9436ecf41
263,243,36,1872,122,2273,88d7fcebdebb726c6dc561bcce7916ed1d5256d7
264,243,36,1872,122,2273,a10b4c010ab2cdaa6ba8bfaec3e3540299ea77be
266,243,36,1874,122,2275,418f75d55f2612066b5bd27171026c20af317716
267,243,36,1874,123,2276,9d0c600d8d6359107cdbef5f0c30757321da09f6
268,245,35,1874,123,2277,727e40c879f893a2c336e396aafdcad60b5d224c
269,246,35,1874,123,2278,5564d0f2ee9b33d30471eafef30efa71c7c47459
271,246,35,1874,123,2278,a7bc00e17bebe34cdf23f744937b3c386ee73d81
272,247,34,1874,123,2278,4e7ed8d0d3e29e21d46abe06ac244da3754c82cc
273,248,34,1874,124,2280,09595b4fc67ac4c94ed4e0d4c69acc1e4a748c81
275,249,34,1875,125,2283,872eb26f542caead338d6456b345ca2f5c0684e2
276,250,34,1875,125,2284,923da0274a9a8c4ef2ac9776f71bd14628e39fc3
281,250,35,1876,125,2286,3caf7efb44712f89d6552076c240a3c898673a2c
283,250,35,1876,126,2287,75bc5bc634e90d5ccd2d7fc324df878dc5d4ce5d
285,250,35,1876,126,2287,6bfd864ff2a7d4903d485ee40094a1315da8221b
289,251,36,1876,127,2290,f8e8853b51476af1cc75a229dadc990c9ccf45ec
290,251,36,1876,128,2291,0b5abb03218ff0c575cee0c83e446bab81cbfadd
292,251,36,1876,128,2291,99d40c6f658ead97f67d331eed9278805c8a4007
294,252,36,1878,128,2294,d72e0178e9930c9967c6fe6cd8c94b3413a240f9
295,252,36,1878,128,2294,910638fc4e4f83bda31dd91db5017acb06dfc8d2
300,253,40,1879,130,2302,fb5c7748daa25a40bfc62834acb5731c71a6b713
301,253,40,1879,131,2303,d3bf5e7b0016edc02e125699c0b0d3aa93404940
302,253,40,1879,131,2303,62261ddd0f2d5f2e6bcce013f2913cdb1b1f0be0
303,253,40,1879,131,2303,8ca9bc5ec326c0b01634dac264a9ba6f0857483e
304,253,40,1879,132,2304,355c5edd9390caad5725375abca03460805f663b
305,255,39,1879,132,2305,188a2418807f661eedfc675731521f2f46a3c49a
306,255,39,1879,132,2305,33b1635a90564a26054930caa0dd8f5be31e101e
307,256,38,1879,132,2305,d974c89ebb8a59d91f664035d98d42dbb5cdd592
309,256,38,1878,134,2306,02260ea3f61b2fe0a0178528526101ff578c7400
310,256,38,1878,134,2306,f47c796b52a3c504d487c2484153fa5d90a25a74
312,256,38,1878,134,2306,24003295088ec24d823f66bd5c8b917478b24c5d
314,260,37,1880,134,2311,8097e5483210fa8c9d6142f1d48e1caed6d7b7bb
315,267,37,1880,134,2318,6b6d13bf6ed02c345912829e3850a201f113712a
316,272,37,1880,136,2325,36e90d1f45a13f53ce25fdc2d9c04433b835c9af
318,272,37,1881,136,2326,e9fdecf98417e39a93c81a854a780550321a9795
319,272,37,1881,136,2326,d5a0accaa090e4e65486930dbddaae5ad72aca3d
320,272,37,1881,137,2327,f54c0ec06e390dc5bce95fdccbcb51d6423da4f9
321,272,37,1881,138,2328,bae72bdd2aa93472617ed28fc3d5a01f0920ea6e
322,273,37,1881,138,2329,9346e45f84e893363e4c0d9b5b4bcb1a62434c08
323,274,36,1881,138,2329,36eab95e7fde7fad4368192ddbef4e2dbb32dc91
326,274,40,1882,138,2334,e15c55e2bf5eb2f1073d18b4ee6fdce2369820f2
329,274,40,1884,138,2336,039d7881b441c6b358a963d652ffa2eada3a8892
330,277,40,1884,138,2339,b5e0eede406633b88c6222031171f80876d8f5e1
331,277,40,1884,138,2339,37e23c606031d5b34197e196fb6e6fed0137bb37
332,277,40,1884,139,2340,ffe83d16bd0abfa58e4448cf9d48b52cc43544e9
333,277,40,1884,141,2342,b44ed404c78e93e6afea0b011eead327e65fbd2f
335,277,40,1884,142,2343,1a1f16d67da7080241ad9f6b4325f22364ac57ba
336,278,39,1884,142,2343,e4b7daec11c3849f5dae46ddfad5fe9ef03c2482
337,278,39,1884,142,2343,b93690c4652a108b4305c0df34509bfc267fd927
338,278,39,1884,143,2344,258d81acbee252693569e3d4e5f95d3dfe3b0638
339,278,39,1883,144,2344,6e8cb75e3edef1ed440e29c31966c44cc1598339
340,278,39,1883,144,2344,4cd727095dbaad5f8ecfcca226e6f3e06ce11a01
342,278,39,1883,144,2344,1418f7530455abf3e6f743164ae15ee6b2566a3c
343,279,39,1883,146,2347,d9ff5ef36d3f714736d633435d45f03eac9c17b5
348,286,45,1885,146,2362,fc2147152637e21bc73f991b50fa06254af02739
349,286,45,1885,146,2362,65a7a0d9eed4f4da9568cf0e7688e7a8c9f01957
350,286,45,1885,146,2362,8ae04e76301bcc5f72a73b7d26876a650bdf18bf
351,286,45,1885,146,2362,dd99f57710bb4930561a6c049f54719af80850ec
354,286,45,1885,147,2363,b9e972b96171236c40a8a922c62d36b49854ee52
356,286,45,1886,147,2364,37682368a604e08f3135375c85529e566492a352
357,287,45,1885,148,2365,8efea1b8d5b5fb0cfef1a3244c339cebf8af36c5
358,287,45,1885,148,2365,269a5dbdd37362e27b2bb3bf3a600ffd5ea2c3bb
359,289,45,1885,148,2367,143255c8bbefe03ff755d7859f029f0bc7a552aa
364,289,68,1890,150,2397,8a1824d465a551b44376f17c01ef142cc036e863
366,289,68,1890,150,2397,76d26d89220f5740103a16bf71df2ae255c00da4
368,290,68,1890,150,2398,1521861b3cc07fffdbe95c41000bf8e8ef92cc6b
369,290,68,1890,150,2398,faad6070ee2eeea270c76381f9ca5999bf1ac15f
370,292,66,1889,156,2403,26996e2d55719deb0a0b85c642c88658c929106c
371,294,66,1889,157,2406,2d76b61dc2a45d5acda53736433a22a1b74e0514
372,294,66,1889,157,2406,0f2e82b9ec9797147945a6f9a402b5ae0fb1d9f4
373,294,66,1889,158,2407,86aaffa5a3510c007167d116cf4ad72b79e93f31
374,295,66,1889,159,2409,40768ec29dc0a38c3b824b32c1a9167c0e8b5ee0
376,295,69,1891,159,2414,4870b304f2eabee3ec761f2d94b6251cae418f49
378,304,65,1891,160,2420,eaeea6f94701547ce1b50dbcf5cf71460e9e4c91
379,304,65,1891,160,2420,9c2d8cde77ee6edd407e92f93eacd4624290394f
381,306,65,1891,161,2423,4a438e400b7ce0ab9d0b6876196cbe8d620a4171
384,307,64,1891,161,2423,31e6c9c8e310e68a96c1f76b9657242c6cecaa4d
385,307,64,1891,161,2423,2b086229a2a6c786e32da37b6b122c2cc894450f
387,307,64,1891,161,2423,63f9b633f9cb620a4c4764b47dca127706a8d7b4
388,307,64,1891,161,2423,29e90f3ae0b0b72bbdf342e0136414bff917c6a6
391,308,64,1891,161,2424,57202a112a966593857725071ecd652a87c157fb
393,308,65,1896,161,2430,2c3ce26beb254101f12fa69cc341ba9aeae62029
394,308,65,1896,161,2430,3c4fca271bd6850d252c4b637871e597484804d1
398,311,66,1896,161,2434,69ddc1b3da043195a0f4e09211d395724b42c70b
403,312,66,1897,161,2436,0894643e40327e48397573b7844585618200442b
404,312,66,1897,161,2436,eef95ea96faef0b7dbbe0c8092202b74f68a899b
405,313,66,1897,161,2437,db0a0c4b8ae490d0596f2c210d3edba3d700374a
406,314,66,1897,162,2439,1563b897c439370fe98e7902004cdcefc9ea5ceb
408,314,66,1897,162,2439,5c412dd8a724b263489c1bd7a2fea381460665d7
411,314,66,1897,162,2439,69125ce90453f94c92432be1ab67768db514c82d
413,314,66,1898,163,2441,9096e2b5f75abf8e8882937bd3c3d47ccdc24e25
414,314,66,1898,163,2441,7b05d2fdaed582662d8f79130932f600f4f966a0
415,314,66,1898,163,2441,fe914341c83b37fd6aa8fd85620cf49dd2328ab0
418,314,66,1898,163,2441,6123e6134fba627a49ad379edfc20ae0f73bc9ac
419,314,66,1898,163,2441,4dcc6493418c78db07761180bf6265f5b2bbccbf
420,314,66,1898,164,2442,d084176cc1273d5faf6f88eedb4c490e961f3a68
422,315,65,1897,165,2442,783572abc4cbbdf3272801d5d19ff8d7d5f2189d
423,315,65,1897,166,2443,10f7cfeb2df35c5f7775d59c9d654952971897fb
424,317,65,1897,166,2445,d1df1fd2bb274574fd895f6984892b3aba372f48
425,318,65,1897,167,2447,adff499e47d99f6b40307acc1ace95508e3c5910
432,318,67,1897,167,2449,681df1aeafb30092430157f7977f713e1ce234ca
433,320,66,1897,168,2451,1a62f197078eae72eba85f23aabacc06ad4c7d79
434,320,66,1897,168,2451,b99114f67f0e5eba3b1d31641906b75a14fd2fa0
439,320,67,1897,168,2452,8e86d9d3dfd68bebbfd1dd5006e0c25696855269
440,320,67,1897,168,2452,be9d645346a20a6c394bf70d47b1b1d5c81ff530
441,321,67,1897,168,2453,adc57632bc26cc8fe42bdb6aff463f883214980a
442,321,67,1897,168,2453,bd53db5eab05099ae371348529c6428e0da95c6a
443,321,67,1897,170,2455,70779d9c1cab77791c73b72e8a63f60184d8f2b0
446,322,67,1897,171,2457,f7b297815819153b53dc1125d3f42869fb1b7ebc
447,322,67,1897,171,2457,7c7b85510656cc814814b85bc52201bbd91821a9
448,325,67,1897,172,2461,9de9c240178bd9f61f55dad07e76ea458f0291f5
449,325,67,1897,172,2461,4f3c44424187de20d7f75fdde6624b9f683a9cf2
452,325,68,1897,172,2462,81d4ce4a6d21f0e65cabb253927770b3616cb560
453,326,68,1897,172,2463,3c8fe5dddf34533a419d2deed5208a28de32cb4a
454,327,67,1897,173,2464,f61c4f490dc4c8ec6ba94ad4f40247db2425fc3e
456,329,77,1904,173,2483,adf5d75af1418b044d7ea335896e75277da06b77
459,329,77,1904,173,2483,ae635cc365581889454d2b3c278b3e3a38bd7809
460,330,76,1904,173,2483,2dee853ed4def42b7ef1b3b472b395055543cc00
461,332,75,1904,173,2484,3226050358cfcffcb14f7e48e3a5cee873388406
463,333,75,1905,174,2487,70e3e2e08ee1d07343d48b1db9df838db3efb0e2
464,333,75,1905,174,2487,c2bc1cefdcbbf074408f4a4cace88b315cf9d652
466,339,76,1905,175,2495,ec186572e6cfde4cd4bc1491ff552c5d32211d9f
468,340,76,1905,175,2496,d9521f66b1851b0eacd55bc78f801dc64123e333
470,343,76,1906,175,2500,ed83881e648771d22658f21b939f66e75c499864
471,343,76,1906,175,2500,2a05a82311f631f314e2918fdb7de983b4c5682a
476,344,76,1906,175,2501,307acc745a4e655c35db96f96ceb4b87597dee49
477,344,76,1906,175,2501,dc8edc9dbf0ec85a60f1129b7b1dddd880162415
478,344,76,1906,175,2501,7b027c463e83f4397dd1a64a4993193c5eb39a51
480,344,76,1906,175,2501,f5da4380723c93998a4f5a845b6f26fa51a2cfe1
481,344,76,1906,175,2501,7d97c5745e420e3edc22965a2c68c8c9d2eab374
483,345,76,1906,175,2502,e89c3a46035e9fe17c373a6c9cd63b9fd631d596
484,345,76,1906,175,2502,1046c8afecf719eee5a2aaa28b001e731f94100b
485,347,76,1906,175,2504,ae1efb853c159ae4747d105405694245f8508b4b
486,347,76,1906,176,2505,d091b75eefcd02872f7d45e9f5f5dd2fa719bbff
489,347,76,1906,177,2506,fb94e7b8cf8f68629b51a4d4f2c37400ef1c7469
491,347,76,1906,177,2506,bc87061a3c7c8d6b4d2469f35cc78683c6cff647
492,347,76,1906,177,2506,3db21c351b9b1108954c388799d35c8dad7dfc19
493,347,76,1906,177,2506,8bf1449edb4139451643e3823b194b4c02ca7633
494,347,76,1906,177,2506,ead36e8a471389a6032d825c8245245ebb89ea5d
495,347,76,1906,177,2506,c15b0c27927afd141d311dd9bfe68540cf44a8d6
497,384,74,1906,184,2548,be67400b477c1b0e7e81766f41bbceed0de74bdc
498,385,73,1906,184,2548,088579638b160f3716dc81d194be70c72743593f
502,391,71,1906,191,2559,655f52491505932ef04264de2bce21a03f3a7cd0
506,391,71,1907,191,2560,fc3409b0932959f2aca42715e9147113d0e40f79
507,391,71,1907,191,2560,32f0c8f79697391e7067f1479045aa910ffa2c4e
509,391,71,1907,191,2560,97e1160be51e4dfdf35e6ba9d93eff5a52bccbe3
511,391,71,1907,191,2560,e11a08ee155811e5f0b2a13640178f82c928c4e7
512,392,71,1907,191,2561,70faaccc3eef916e1b1ba5c2e93799074e66a5c3
513,393,71,1907,191,2562,0688a7946afac04123309afd29c95319a8d59392
515,395,70,1908,191,2564,04e8d890aec8e996d568565555164a27a6a76057
516,395,70,1908,191,2564,170f7115bbae45f26ca8078e749dfe67445a57ea
517,395,70,1908,191,2564,9ef2615d4968ed52dbd88a19f03746a2f16c7511
518,396,70,1908,191,2565,43b2d88a5b9cfb151ccf7ac861f2750e70c0e2c4
523,398,70,1908,192,2568,4525a0c4669dccb3a4c5d865184f8bb8e4a89ec8
525,399,70,1909,192,2570,614bec41b5306b32b8de20d66f047ff8d6f35256
527,401,68,1910,192,2571,d73176a84273c06fa11075c65293ec28497a8423
528,401,68,1910,192,2571,4ccfc4439a7add24f8db4ef3960d02ef8ae09887
529,401,68,1910,192,2571,4df7e8483b2679fc1cba3410f08960bac6f51115
530,401,68,1910,192,2571,801a84ae329a24d9adf01b700429fe8f1285b2b8
531,401,68,1910,192,2571,f4cb350c7980f94fbfd251b6e6385eef9a7df427
533,401,68,1910,192,2571,ff8a02ae0b33ee52050e22909d432a3aa060d683
535,403,68,1910,192,2573,70be31bba7f8658f17235e33862319780c3dfad1
536,403,68,1910,192,2573,300e8baf9429dbf1c5dff478558d793638dc2f54
537,403,68,1910,192,2573,80ad5472ce4b6ba6e94227422d0727371e97cdf0
538,403,68,1910,192,2573,ad0f0daf8c6aa80775d68068a76c5b6d0fff04ec
539,406,67,1910,197,2580,3653466bdf211ca603ec976c28d4a8da566dc671
540,406,67,1910,197,2580,8047e3666b0b50bb04e6f16c2a4fb21ddfd5713f
543,406,67,1926,197,2596,38eacbde62cd83ffaa64db7719c2c643f69551e0
545,406,67,1927,200,2600,33ea472f6924480eb8708bc6d0ac90b9f742ba68
547,407,66,1927,200,2600,e60cce4e401ae9481b66b6c7821e85237f1baa1a
548,407,66,1927,200,2600,c7805ee214802ff1c0de53660bd2594bc1abfebb
549,407,66,1927,200,2600,c954931abd17f8efaa6b7662ac2916dbf47d2978
550,407,66,1927,200,2600,59383f1e3a8ab5a6477dbd5bb1d7c32366a9d8f8
551,407,66,1927,200,2600,d29ed3f355b0c57e7036807f1d54f33796d8d820
553,407,66,1927,200,2600,076a63e672370ff1735e7942cd1ae0990bcbd263
554,408,65,1927,200,2600,44f3ee77166bd5c0e8a4604f2d96015268dce100
555,408,65,1927,201,2601,0b5fb8e72c74e41d250f35c8c3df3f3a13d367f3
556,408,65,1927,201,2601,5ab86809832726957dd6f0eb8e17a461f0a9be84
557,408,65,1927,201,2601,e1e6399c2ce39a3656155c4d704340eac83926a7
558,409,64,1927,201,2601,2913d6b77d8b2082dc79df5503b7dd3ddd05fcc1
560,411,64,1928,201,2604,262d4db8c4c849b0fdd84550fb96472446cf90df
561,411,64,1928,201,2604,84522c0d165076d01cd034d7c381b75044daec8d
563,412,64,1928,201,2605,002b3d87b5f1e35edcb6e14ce2e2827fc6c032a1
564,413,64,1928,202,2607,23048d186ce0041654a9f547fe3e7177efce3076
566,414,65,1928,202,2609,492537ac18df56c36f8a2335d773aa0fa01a61a3
567,414,65,1928,202,2609,7c637a3aaec311269bf863c220bf894eebbe7c7c
569,414,65,1928,202,2609,5c085ea7b3f3ff10389aeed327e018581791876a
573,414,65,1928,202,2609,19e67c6cd13d6442abb2a6eba1b7fba80dcf5457
574,414,65,1927,203,2609,238e2ac3690755d0e6c2dfca815e2b6f84a47f6e
575,414,65,1927,203,2609,3e9b5bfd9c3e16c968278f7d050f52739690eb29
576,415,64,1926,205,2610,5c125f63f77e169a459c11bab0f639c83fabc6e2
577,415,64,1926,205,2610,5c98223f39e5cf92c603a08e7ed70d57e565a5a3
578,415,64,1926,205,2610,5987b3c46d5a6948737627d294d95ed54d49eae6
579,416,64,1926,205,2611,7bda2d8ebc7833747363ac837fecb6535c817dcd
580,418,63,1926,205,2612,40f0a84cb151669313faadf857aaddd18d39aaeb
581,418,63,1926,205,2612,0207bdd2d4157c542c981264c86706b78ca246e9
582,420,62,1926,205,2613,6700c909358d2ff9ff96f28dbc549906d8d32206
583,420,62,1926,206,2614,2dc93bb10ab1c2af1df9977f1b51d47cadab7b21
584,420,62,1926,206,2614,ed63df3fc2f0c228354ca3435e9bed45be9d0909
586,421,62,1926,207,2616,fc19f9315be312b5e5f00e0004b8696e36f852e7
587,422,62,1926,208,2618,35291df7f786f8c9b8177e4baa286e6f12597407
588,422,62,1926,208,2618,071801ccff970682a799ce754431a3c3ce3d6902
589,422,62,1926,209,2619,f954c517203d1fceaa1de26b17b242690cc138fa
590,422,62,1926,210,2620,4ab53a558ac01c2dd7dafb8350cd72c630372335
591,422,62,1926,210,2620,14dead04acf4ac877d0f4025f142fe9e872ce8ac
594,422,62,1926,210,2620,c91bc68e9a5f9f1e2cce00d01d62d16a858155f0
595,422,62,1926,210,2620,cbe4efcbc13ad402bf1f1a94b02a8ec93f20327d
596,422,62,1926,210,2620,286d0e6ab1e54906007fda86b6cb6deb26c6deb2
597,422,62,1926,210,2620,6b418348558e7efc5bac459989887138a3045886
598,423,62,1926,210,2621,f0450c9b1298bf5f39e229aec76c9bf7d57d4479
599,423,62,1926,210,2621,541f4ea546ad3065852db816769ba6b584e3f373
600,423,62,1926,210,2621,0a899157836cc4c3d3980ab6a70b2f37bbb7ba97
601,423,62,1926,210,2621,2926559cce34e48efb4b073721926d737e372dd3
606,423,63,1925,211,2622,3fd754f12df42d173b6e9a93e7c32f8f5be55e7f
607,423,63,1925,211,2622,dee1bcd08a013ba5ffd8d1ec9b6628702f755066
608,423,63,1925,211,2622,08232ef84d4959826ad5136f183c9fc5bedf0599
610,423,63,1925,211,2622,a391b17ad24bc5f255a3928c23c158c79004c656
611,424,63,1924,212,2623,1ea87c8c7974acb5fa795362253c61b38f3cb137
612,424,63,1924,213,2624,bc77eb6d0858652e197c08c299efaeb06c51efee
615,424,65,1924,213,2626,1884bf8e8e9fb3f9f44a9ec216aca96f63974268
616,425,65,1924,214,2628,eaf4d8c0d85056c3481986fe092d5a8786bc4f26
617,425,65,1924,214,2628,20ff296cb15a53b8b9517a834688e57749b43e21
618,425,65,1924,214,2628,f4416b1a8b92e492707a6261b7a1132f8550457f
619,426,65,1924,214,2629,1daae25bdcd735151de394a5578c22257e3e5dc7
622,426,65,1927,214,2632,c19bc2d5d49f373b274772fa6cd936dfd05761e7
623,426,65,1927,214,2632,1f5b067710a6bc97848b1caff0e2a685c2489868
624,426,65,1927,214,2632,167a3203b645341a3b00b878594bfd8d4dd6b040
625,426,65,1925,216,2632,8b1f39a727be91aab40bdb37235718ed63ae1d50
626,427,65,1925,217,2634,39937de7e60052d3ffa9f07fdbb9262aced35d61
627,436,63,1924,222,2645,1e82094f1b6690018228e688303295f83e1c3d9a
628,436,63,1924,222,2645,9f825b9e28547b1310526c9be9fca9e6dbcd57e7
632,436,63,1926,222,2647,fd0949181f993fb8a15c5b0128840f71ee1d7b0e
634,436,63,1926,222,2647,90c59db7a3e1c9725ed6e3683ef8beba4eb77333
635,437,63,1926,223,2649,a0047c6242fd48068eb444e0a58f7a5d2bc1bcd3
637,437,63,1926,223,2649,55b3bd84681a87266f6bef72480aaef48a7c295f
640,439,63,1926,223,2651,5d428908218e3692d1bc7e4ada6235029ae9e45c
641,439,63,1926,224,2652,64033fd08535f8043557f53b62a348e093325286
644,439,63,1927,224,2653,3c593ba79e5bdee46419e2aa6b14e7ce8bc01758
645,439,63,1927,226,2655,e93e0c03b28137e26f9249e0b7c458b0d667a74e
646,441,63,1927,226,2657,296919e7a58c21ff0325de8c747dc2dc8960104e
647,441,63,1927,226,2657,d58573e60d7139711e24410741ef508bf0d124d8
648,441,63,1927,226,2657,98df288ddaba9787e4a370f12aba51c2b9133142
649,441,63,1927,226,2657,5304494585c58b0c9245ea9896a6d6122a8673a2
655,442,63,1927,226,2658,bfb5b7150ff52571a7a3cf10e0dd0d1dbd45c4b5
659,443,66,1927,229,2665,3872a33132a4bb6aa22b237927597bbfdf6f21d7
660,443,66,1927,229,2665,d34d39ade76e6b67299d8d88a7e5a2278a793dc3
661,443,66,1927,229,2665,65296b3be376e9cd25216b6ad2b1758b03765781
662,443,66,1927,229,2665,fb1ba4d63e76c418c2dd6214dabe4dcf25ab3bad
663,443,66,1926,230,2665,e470f311d654267ec86f9a6325ec500345b9dff2
665,443,66,1926,231,2666,e6dd7f995a5a785a5aa12378df209314b1d77d93
666,443,66,1926,231,2666,09f2cdbe1a43e79e31f5ea509b59d4c87db29832
667,443,66,1926,231,2666,fbc618c13cc72b9c2f4c8dfd5ef8b8ab5a5d7caa
668,443,66,1925,232,2666,cf6ce279c7671a4c83c960c5c526f92679a4fac8
669,444,66,1925,232,2667,3f2de803181ca3c5526ec9d708b2098b8f683808
671,444,66,1925,232,2667,81aae2884377ff1a60b74e510e3358738971bbc0
673,445,66,1925,232,2668,9aac99e96d100b34b6daa3a137531eff4f17076e
674,445,66,1925,232,2668,64a4211aa85795cb21a73bc93f9e43bafa1541f6
675,445,66,1925,232,2668,2f615b10e6330d27dccbd770a4628200044acf70
676,445,66,1924,233,2668,e5cb4e14118f3a508e3bc00ee7cd50bb0f18a61d
678,445,68,1926,233,2672,b3d5dc6932bf896a909e9871d508654494b34563
680,446,68,1926,233,2673,74261bc593bcf9411e7e25a4731dd9471499819e
681,446,68,1926,233,2673,20c6ba6ffa9d68cad21fcfbdcb1a7d72eaee143c
682,446,68,1926,233,2673,0d97e73d95379722b8044fa09b1c1c4ee4c0a486
683,446,68,1926,233,2673,27c839e0fce99254ad61322bb827a821f832e840
685,447,68,1926,233,2674,d3d66d47222dd8765a20a15fdc754c0ed7635404
686,450,68,1923,238,2679,b769bbd4f6a3cd1bcd9ebf3559ec6ea0f9b50565
687,450,68,1923,240,2681,9368f51e1273c56ca40e396ef5a1aa0aa7c91871
689,450,71,1923,240,2684,8b7bd62ae52313dbe96f27f21fbd63f0dd061744
691,450,71,1923,240,2684,738c0de3000c5a1e287f10ddf2f99e0c5e127250
692,450,71,1923,240,2684,4a6656488893b6a832726cade2d2c5aa04f85ae2
693,450,71,1922,241,2684,1c90a3dccadc7d2da3704ff17ac9ff1a67743934
694,450,71,1922,241,2684,e7b4bd48c7b81718cfae6f30f1868cf45311ca86
695,450,71,1922,241,2684,7f155a07032caf916518beca5b33fa5a90300209
696,450,71,1922,241,2684,73040e584a9ccc770593a3885f5fe40fda142e0d
697,450,71,1922,241,2684,34047b23e284fd3459903294a5776b67c3e33ed9
698,450,71,1922,241,2684,e75b614640c206bf6d0b1c9d32c54434ea719582
700,450,71,1922,241,2684,5ae0dd6abf8f93b90c962e62b04c675fdd6ca755
704,451,71,1923,241,2686,290ff35e6cc2580861a6fdeaaa3d4aa6d75f9edd
707,451,71,1924,242,2688,c0fff64486198ee8885f4f951399a3675f01e3cd
708,451,71,1924,242,2688,c078021555dcda6b12363b5b0646eac5332a0d86
709,452,71,1924,242,2689,6355a6d4f59eb220e05130d179beba7bb29c88af
712,453,86,1936,242,2717,bdb382b2a49de4a2426c3dde944776c1bdd08eb7
714,453,87,1939,242,2721,6364df68879efc0d9451d6427e34b4542e3d7e0b
715,454,86,1939,242,2721,b43b27bcdf84e816b886d4daf83131949708cecb
717,454,86,1939,242,2721,ad82d0003b5a3694028119bad580b090e994181e
718,454,86,1939,242,2721,60879a2193fe79b3853c60782fc4f1fdfdd55d63
719,455,86,1939,242,2722,d3e12c901777697b7bf08b25e2dd46f0b951db8c
720,455,86,1939,242,2722,b647ccfa673890d4ee30a29bb759a19e4f1a67dc
722,457,86,1939,242,2724,a50b66da30320887c23c73927f6b2ab41e0301bf
723,457,86,1939,242,2724,2e70bf37854e39d46557317fb4098da5261618d5
724,457,86,1939,242,2724,e291fc4757e952fd4f663d88adca416b016db13e
725,457,86,1939,242,2724,6c592e79e108831eba22826a346838ce05fefeb3
726,458,86,1939,242,2725,4a66a69239c493c05b322815b18c605cd4c96e7c
728,458,92,1947,242,2739,f59667c121272ba7a1161e8bc4787654d929f6f1
730,460,91,1948,256,2755,ec4f219ecb7a5e43d0353633fac4dac42d0ee492
732,460,91,1948,256,2755,9ed82154bd0bd01c6195942db84302e791ad366f
733,460,91,1948,257,2756,aef2a0ec59301022354c043744a6a2fa13583aa1
736,460,91,1948,257,2756,c0cf73a57d7f77af348aeb854e7b4f670dc3cee7
738,462,91,1948,257,2758,c31bf8cb54e591e244abc951896ef5e4a089f38d
740,462,91,1948,257,2758,4352e865a75923a0e5036b4e9ba2a8f0bfae3d63
741,462,91,1948,257,2758,9f0d67137c98aa296471e1b7f57ae43f5bb17db6
742,463,91,1947,258,2759,00a1d4d042a7afd139316982c9b57e87d26a894f
743,463,91,1947,258,2759,aabb58428beae0bd34f32e5d620a82486b670499
745,463,91,1947,259,2760,b64c0d4d613b5cabedbc9b847682fe14877537de
746,463,91,1947,259,2760,3bbaf84d6533fb61ac0038f2bbe52ee0d7b4fd10
749,463,91,1947,259,2760,b35b43dff81d46e930ffa1e05eb50968b8557102
750,463,91,1947,259,2760,839edcebb39f55acf163266f1ce1f0dc537de95b
752,463,91,1948,260,2762,b44dee16e60ff2600fee90576e5bf0083c266104
753,463,91,1948,260,2762,b535eb3fcb6768b2ee2a900c3ca7217b5aecffa6
754,463,91,1948,260,2762,11cac1bd8ef7546ca32d9969d4348bf412dc6664
755,463,91,1948,260,2762,60f795c0608119cdb02d61d3eb59f34ebdb55754
756,463,91,1948,260,2762,fedef7b2c6e80e1e58b028cf9c03267a8950bf6f
757,464,91,1948,261,2764,9a5cfa05a0d889db9daa7872a9697daa883f3609
758,465,91,1948,262,2766,30a152a367541a0b815ab84b3da407700feff744
759,466,91,1948,262,2767,61f3e22e38516d8284a45e2b2792a61d541f9e78
761,466,91,1948,262,2767,c6cce4de38662d49d5eaaf197b62937f6ce25be7
762,467,91,1948,263,2769,a570701e02e0bc09d977c8ae0b6ee987a1190039
763,467,91,1948,263,2769,c0c7fa4837c85bc510462f0be3882c6220dce728
764,467,91,1948,264,2770,ca58181bac5366d3a1fb44e1b49fe9e365095138
766,467,91,1948,264,2770,335368410210ce0e27e0068b3a2a6cdf4baa956b
767,467,91,1948,264,2770,f9c3587b51487179cf3fb92b509790f4610d6012
769,469,91,1948,265,2773,b91a2a499fd562011fd275238924baa6002fb1f8
770,469,91,1948,267,2775,f5d5867a4a6aeddd58ff855a01ab4e438d938ac1
771,469,91,1948,267,2775,a871cf422d8f7a15d3029684538136e0c92f99dc
773,469,91,1948,268,2776,e7c6a2cf9f37210ed4f784691e44389f38f96d80
774,469,91,1948,268,2776,69483e022ac3ddd02f086a264c3eb5e3345ccc0c
777,469,93,1948,270,2780,bc98bc56a52860688ea0ae2ec7b9e59ddb72a811
778,469,93,1948,270,2780,6bd8462380e1c078969867d9a0f4871fcdbe52b4
779,469,93,1948,271,2781,0d71349773f8d2e8160d76b5c91a1896ece772db
781,470,93,1948,271,2782,e5cfa394d79b6ab1b412bd3b30c6a433b415d56b
785,473,92,1948,271,2784,df049ed77a4db67e45db5679bfc76a85d2a26680
786,473,92,1948,271,2784,014247ad1922931a2f17beaf6249247298e9dc44
787,473,92,1948,271,2784,17d3a6d8044752f482453f5906026eaf12c39e8e
789,473,92,1948,271,2784,7b6d3104f263d9483982928604b2e51f06126ec1
790,474,92,1948,271,2785,07577a2d05fc33ebef062f97a754dd53079356db
793,475,91,1948,272,2786,f675afa13ce89ea25a9798b2f7a57b091bb83dfa
795,475,91,1948,272,2786,2e05ef4e18c8fea0c199e4fc32278cce11158ac0
796,475,91,1948,273,2787,f0857c09fb51b21afb3e55da53bce962466af6d3
797,475,91,1948,274,2788,074a82f49b1443e66885ea861bbd2d2cb04af43e
799,475,91,1949,274,2789,0b02ce54cf58f96811a625245e374e6cd10e28af
800,475,91,1949,274,2789,d72f8862cb1a39934952e708c3c869be1399846e
802,476,91,1948,276,2791,f576b23a652eba69667ab3ce42aaf5f6b3e6f4ea
803,476,91,1948,276,2791,d62194a260eedd30aeea78f407032aabfde4be70
804,476,91,1948,278,2793,83f63730306fa3cbdcbe7f0dcb36b0cdcfd1ec4a
805,476,91,1948,278,2793,6f403056f09b0a77df9791125591f3057e328ab7
808,476,91,1948,278,2793,915ef79b08862680e82d6a772d6ead22735e9a2f
809,476,91,1948,278,2793,76ac07a90967acb0225d0a590164ae1b7ad0e6bd
810,476,91,1948,279,2794,97bc875234c5578a16e9e89be2b3431153e7b413
811,476,91,1948,279,2794,a2b999dfcac9bc92513a36ec6b3033ded1561c66
812,476,91,1948,280,2795,db97a8849519a3933bf4abd2184efd68ebc21965
814,476,91,1948,280,2795,24620d71f2116da31abe6c9391f7bc807ac23c0b
815,476,91,1948,280,2795,6bdd3840be63582531c3125a26cd00294e6f8346
816,477,91,1948,281,2797,8f8c54f70bfa3aa8e311514297f1eeded2c32593
817,477,91,1948,281,2797,84bc4f6cddfcb5fedc7586644d66d025476255ad
819,477,91,1948,281,2797,561c018d88203826cb9fd370e03a28e829871b75
820,477,91,1948,281,2797,0ffa3943fbd100e7de7b1ddbfd301ddc52b57410
821,479,90,1948,281,2798,035b0fa60da2e758d0ab7f9d04ef93cdb73c981f
822,479,90,1948,281,2798,8ee6a3f1a855bf983639a14fc2393baa8ead741f
823,479,90,1948,281,2798,b356dc4e07915521db1e768d6357e3d982877a6e
824,479,90,1948,281,2798,c96f11257baf43188ff9daeddab3221992925c85
825,480,90,1948,281,2799,ed514caed20995814712fd6c9e9c4120b4ac64be
827,480,90,1948,281,2799,59c3a140eb41e0f186adf9b57029bd67beb8016a
828,480,90,1948,281,2799,48af591b2dd1f4c6b87558698f311dd7fe6dbbc0
830,480,90,1948,281,2799,c52822e7501e8478abf99465d8c9f3102dde618a
832,480,90,1948,281,2799,1fed8dd715cc734f51c162d4362d34d357925bc4
833,480,90,1948,281,2799,1ef4aeab403f7fb74c0b9b11fde854fd03afc40c
834,480,90,1948,281,2799,2f6bdab1597ee42b36752bf9f624d3386e951379
837,481,90,1949,284,2804,f8cc464452f495fce2a3d6f7494396c8f798a1e6
838,485,90,1949,284,2808,e25ba6e8bb6054a2c5592ade12ec6fe095ba75d1
845,485,90,1949,284,2808,efc144aba064510abc0fdd25ec3deaa3e6f27427
848,485,90,1949,284,2808,19fcf083d364d734a52ccab0ad51143445be7b7b
852,485,90,1949,284,2808,baa732ac9f18b6ed0ca386c632e15c9fb3037e39
853,485,90,1949,284,2808,d7848c11e008ddeb036a95d389caa3b2c97b795e
854,485,90,1949,284,2808,f5e9d67907510881c7f132d0a80e39f47caea5f6
855,485,90,1949,284,2808,774c16d16ed67d7cf12bc2b2752768b544bdb363
856,488,87,1949,285,2809,1da170a203819ffda7764e53e3c268b8fc2ab452
859,489,86,1949,285,2809,927b30a6ab33ea33e5e3b1e7408ac1d5d267ff6a
860,490,85,1949,285,2809,8a5eadd140a5f06d24e1c5bc0c444ce11be0769a
861,493,83,1949,286,2811,04e69598de75550a9227bfac353ff5606b6cbe43
862,493,83,1949,286,2811,b60375d4bbb848af7950379e2f35a1a65f7a2591
863,494,83,1949,286,2812,5cedef9b503c127283bba0bf68d5728f094bba4a
865,494,83,1949,286,2812,5281f8b635f10b2839dc146d7e44f7d94d1955d8
867,494,83,1949,286,2812,8eeb566aca33600d272dee5fba59c3445b5b8163
874,494,83,1949,287,2813,e063ac2fae007a2eecaeab5ce17064c31230ce29
876,494,83,1949,287,2813,c296e55dc6a697c7e4d4be92b954633cda4a79b1
877,494,83,1948,288,2813,600fb7c51b22bc0d9138f580bb5e5abcfedc76ee
879,495,83,1948,288,2814,44dc201cb697d264d244abede3ee10a30a387d7a
880,495,83,1948,288,2814,c6da621def9bc04a5feacd5652c7f9d84f48ad2c
881,495,83,1948,288,2814,217f173be025d2cce6484c760ea6ec77436f26a1
883,496,83,1948,288,2815,199a02d1e2adef39b6346a254b097c9ac64a9ec4
884,496,83,1948,288,2815,6024fd5dc2022f3724ea6440c319440d457a7366
885,497,83,1948,288,2816,bc7923beffea3c51271935cad1371a67c5fcc71b
886,497,83,1948,288,2816,29465d438e00660221e1e0ac5e2929a719c56113
887,499,83,1945,297,2824,87d55081ea398c65b2503d22ed3907a9175ec729
888,532,82,1945,365,2924,c2e70f02653519db3a49cd48f5158ccad7434d25
889,532,82,1945,366,2925,adc0c4fbac98f9cb975e8fa8220323b2de638b46
890,532,82,1945,366,2925,6a46f239573369d0f701a1caf037f62b25adec02
891,532,82,1945,366,2925,c0416711672ab289260c4a00a0024da862140027
892,532,82,1944,367,2925,ae32f324981dd64d7c04fcbed9d99356914a61de
894,532,82,1944,367,2925,b1e552debf8303124a213008d319df9a817b4932
895,532,82,1944,367,2925,537818af8783a4f9f239ed6277b1f810c1666839
896,532,82,1944,367,2925,635ffc3c37d58eb96ae17d5389dd50bf635413c6
897,532,82,1944,367,2925,d27e0f04a68cf62088b5b1b3a2c0d6f7e8f89c5d
898,533,82,1944,367,2926,e176de25127a2750ea1c6a705b2c0983b5782b41
899,533,82,1944,369,2928,35901e64b043733acd1687734274553cf994511b
900,533,82,1944,369,2928,5b6ca150730cddb09ff8622d49b273d57b9c6703
902,533,82,1944,369,2928,5d0961fdfc396e755e60d4fa986bab8f45d375f4
903,533,82,1944,369,2928,70912e137d5a6b089f35c662115fb758a00d7002
904,533,82,1944,369,2928,faa2a0f662ed6fe0b90d10e98cc8ee3795d9307c
905,533,82,1944,369,2928,1c7c782d6e7cdce09a982f05d468d538698c3004
907,533,82,1943,370,2928,7f0953ce1f1e263a2a74db52d70cdf278840a1d2
908,534,81,1943,370,2928,1e2362ca0f2805e91204a7b005e5aed293b40c9e
909,534,81,1943,370,2928,434d309ef6dbecbfd2b322d3a1da78aa5cb05fa8
912,534,81,1943,370,2928,0abb06930fc0686cb35079934e5bb40df66f5691
913,534,81,1943,370,2928,fd81588bc64583c8ee17f680e621129c9be83c43
914,534,81,1943,370,2928,f93e7f5674436b230e6b4023570939a20c0c6055
915,535,81,1943,370,2929,1a76257b1b385ac8afd67bd36d061f508613e4d2
916,535,81,1943,370,2929,3bdaaf6777804d33ee46cdb5a889b8cc544a91f1
918,535,81,1944,371,2931,98eb91171d7bb97327c714ef8e816103555573e6
920,535,81,1944,372,2932,53d28f83390aed98fab4eed187eaf1edaa92c6d0
923,535,81,1944,373,2933,14c1fd0730e2fd5ae5eb1c61dbea2e08582fab65
925,535,82,1944,373,2934,a6acfc31837fd7a9e0e387320d995b2c85cfcfce
926,536,81,1944,373,2934,8972818289452d611d97fac0f4a6d24625987b31
928,536,81,1944,373,2934,9f73009e98c51986a50cc45844b8bca72673e955
930,536,81,1944,373,2934,62d4074005f68328b240ab5f4fdfe348896717da
931,536,81,1943,374,2934,f6259ce776eb022d1ca05fc5f4e5bc56ca1a4728
932,536,81,1943,374,2934,4dcfbd792342667174834c40e792f1b8ac2f0609
933,536,81,1943,375,2935,3862c568ac1b920188ecfbe5cd8073160206d6b9
935,536,81,1943,376,2936,74be214e8185c188ef6c1abf3e6dd0adadf5b794
936,536,81,1943,376,2936,34057730a55efe31431070c529031ee5a6f7f47b
937,536,81,1943,377,2937,28cb272a7279e6dfc4d5c53838ebf7343c3e66b5
938,537,80,1943,378,2938,97fa7fe961f961b6c93a11b50a7a1ed35c8bce8d
939,537,80,1943,379,2939,e8cd65f8297928d3fa7ad3d338953a4423028713
940,537,80,1943,379,2939,244404227e8a1c5e241658ef0df789a28ed3bbc6
941,537,80,1943,379,2939,520802160a6c9e9dbe9f5859ae7e084b9000f850
942,537,80,1943,379,2939,16a8d01308f8ca4a7b4673424059424ba3fe36c8
943,537,80,1943,379,2939,3e1bb5cfb8f9676e0c045f0d101a094437133b54
944,537,80,1943,379,2939,f2b665f88610b208196b5753b09b4a5cfb322417
946,538,79,1943,384,2944,ec9004728ee136e3b7e2b7cd2610203e16b6ce9b
947,538,79,1943,384,2944,bcb4fe0012f8f869348ea83f5a35706f4545c44a
948,538,79,1943,384,2944,6ed613b2a52f8719b92b94d815e9f997d262412c
949,538,79,1943,384,2944,a7b7f27c05244d69a11545261eb3bbd73791b3d2
950,538,79,1943,384,2944,69db1c745506bf63026def25d6854755179feaa8
953,540,80,1951,385,2956,a3830f6d663aee9e91871002cbff7c57aee6d989
956,540,83,1955,385,2963,787cc7aa843d5c0834f56b5f8ae03b86ce553c51
958,540,83,1955,385,2963,5980b05c1fad69eef907e0076aa2dc837edab529
962,542,84,1955,385,2966,7fa1dd8a80795d7573fe650014c5d23af7557bc7
963,542,84,1955,385,2966,c9fb4f3c45b668c9a32f9ecdfe404566657df88e
965,543,84,1955,389,2971,b7508896fbe19ec2cdeb81565cd587091b6b68d0
967,543,84,1955,389,2971,d0bd5330432e1dda519ebd89606bd0980a36dcb4
968,543,84,1955,390,2972,0cc059cd104cdb70340bd08e597d403d80dc42a6
969,543,84,1955,390,2972,ece78684d9e09c477c4a0f10236c0aec45bac726
970,543,84,1955,390,2972,52a190b65781f8dc07abd230aaf9043fbdbf4fba
971,543,84,1955,390,2972,de41fbb3cf39cf24387ba03e6a6cfb697a789a2d
972,543,84,1955,390,2972,5b5a27942b2fa113df4d6eb3d77a33c85f58634f
975,543,84,1955,390,2972,f9636fdf922fe49ff82d02b17d6b34469fcf1fda
976,543,84,1955,391,2973,98bcdfa8bd902addd4b8cf37d039b3597d58a45c
977,543,84,1955,391,2973,1f7b25c1a7a85426675a04380f37b180edc08bbc
978,544,84,1954,392,2974,7a40fef17ab7918cbb1ddc3ba080f42b420f7a48
979,544,84,1954,392,2974,dad8434d6ff5da10959672726dc9b397296d380b
980,545,84,1954,392,2975,7eb513ab0f761fe88aa4d3579fdf8706741f2239
983,545,85,1955,392,2977,75b5de8d5f73fcf52a05cd2f82125d7e27bda93b
984,545,85,1955,392,2977,0271a11ba5df58b449a3f968ec57fb1a090c5726
986,545,85,1955,392,2977,8cc41ce7a7a8f6bebfdd89d5ab276cd0109f4fc5
992,549,83,1957,393,2982,197b1878105504b5ac7e399e1f52a6093c88baa3
996,549,83,1957,393,2982,47201371d2805391f4dec3528cdc05f083814165
998,550,82,1957,393,2982,c1893e2839245e75b35597a9200d9ef9c1ad9b46
999,550,82,1957,393,2982,bda408f60bf901620e88d25aad38210985e5c758
1000,551,82,1957,393,2983,1b8d7eff3bb1de1f0b51137d720d6fcf7622bced
1001,551,82,1957,393,2983,333cbdcd2de4546e33ad50ebd8b67e1a1e87aeec
1004,551,82,1957,393,2983,6c6eb8a6917a538968201267f943ef581db1c22d
1005,551,82,1957,393,2983,d3bc86ec11bb22f06b5e30fac891ef3e43f82a6d
1007,551,82,1957,393,2983,26dcf739eaf5577c5072eb8c9ba1c5ac5605683f
1008,551,82,1957,393,2983,7d60659e22c869149cc17f2568a8e073412ea219
1011,551,82,1960,393,2986,45ed19de687d324d3ba852eea93b1afa575e482f
1012,551,82,1960,393,2986,d3fdaf907db6a5be4d0391532d7e65688c19e851
1013,551,82,1960,393,2986,4ce433e811763f29c32e0553fe1e0070fd14c6a2
1014,551,82,1960,393,2986,9324935c3e67c01f665df9dd3a7197a68f8365a8
1015,551,82,1960,393,2986,2a1a085bf1355370205dd44fa60c6aab91ed0976
1017,551,82,1960,393,2986,4bc00defd0cf4de3baf90cad43da62e531987459
1018,551,82,1960,393,2986,ea47a052ba7a097a98993c240ecea96a115f6c25
1020,551,82,1960,393,2986,1175027641f512d33909cb766563328c6b171578
1021,551,82,1960,393,2986,91f701f4fc324cd2feb7dbf151338a358ca0ea18
1022,551,82,1960,393,2986,e1427cc609fa6ab247501b101cfb3c0092aba55b
1023,551,82,1960,393,2986,7bec480fe2ace94c8e7f0c88485442bfa74436b4
1024,551,82,1960,393,2986,e8cbc2b322d873a6fe39faca18d340ce93035087
1026,553,82,1960,393,2988,22bb548900146832459deaefa880660c17a51516
1027,553,82,1960,394,2989,c32b61c6fd6ddf39fd49585954d422ef8d7304f6
1028,553,82,1960,394,2989,22a791e608922d55552da6c7c9ddc81ae29b7ba4
1029,553,82,1960,394,2989,8e631a3175f145dbf3eec269f8e3c59a1520540f
1030,553,82,1960,394,2989,9607a0404188bbe612f05216f5a82df26f4b4e80
1031,553,82,1960,394,2989,2bb1027d6bcdad59624a9d08701e0d2e4a9c0ba7
1032,553,82,1960,394,2989,01b2b0b6543afdaf30623b7a779b7fe4514a9c7b
1033,553,82,1960,395,2990,7ac0cd445e056cac9bfc1fed11026ab6c74b8818
1034,553,82,1960,396,2991,e75882332c8593a1d5a47f9f1e099e9201b12296
1035,554,82,1960,396,2992,b649f68649b0cba2de9e6bb8cf3d3fe468372c2e
1038,554,82,1960,396,2992,c2fcba2ac76cdaed5ccf07ae0521a78feb598825
1039,554,82,1960,396,2992,fe6ddb837d18bd4e71cd22fc18272d31478b19f2
1040,554,82,1960,396,2992,b79fc11d730b5beff92e9dd8853a61524cdeffe3
1042,554,82,1961,396,2993,cbcf78fa949091e037861d66d942d7fb31d57bf6
1043,555,81,1961,398,2995,235caabacc37278487d1107f6bbda90cc208cd64
1044,555,81,1961,398,2995,e34226fc37dfa9eba89d913fd7ab8e95663b0d64
1047,555,81,1961,398,2995,123984ff66c788a7ea36256c152b79dd06e9ef31
1048,556,80,1961,398,2995,9c40f01a66bd15457e10a0bbf28c803968b5dabb
1049,556,80,1961,398,2995,d4b10a725614322769a419180039771634a06571
1050,569,77,1958,408,3012,5153a3bfdcec82324d67ff79862384288cf6afe6
1051,569,77,1958,408,3012,4c30fa905d9d47b3a2ee82095b1fe56cc2ec2ab5
1052,570,77,1958,408,3013,064d4b1cb01cbab0461469254a11c918e6b15cbd
1055,571,76,1958,408,3013,6a98396b9da56bf5eb1c94e037b844eb9bdd1a45
1056,571,76,1958,408,3013,a8eb715b663ff836e54f04c0e4fcafa2ee468b4e
1057,571,76,1958,408,3013,627c7eb7bf81fe4faac552475fa13f449dc8dd33
1060,571,76,1958,408,3013,40bf18e70282784c7923a89c0700a83118b81a50
1061,571,76,1957,409,3013,5ab65ca5c900557f508f62a260f9ea53d9d93f37
1063,571,76,1957,409,3013,233b46f93171d4a7cc279bc3f35e5a99e9a167b8
1065,572,75,1957,410,3014,c92cd22d02349b73d169a3a2ff3b6fe7a54bfb0c
1067,572,75,1957,430,3034,86cd89095a9e92074d7eb93f2786e765ccb843e4
1069,572,75,1957,430,3034,cf29b6b5610f242d18dcc31eb897c873109b67e2
1070,572,75,1957,430,3034,721d8e50ac2e1545ee112000f6e852f56c51d9f8
1071,572,75,1957,430,3034,e133b55943f26e87cff5b22215a776a9ce3fc6f3
1072,572,75,1957,430,3034,d5bac7e4493e7de1e59c744da33b7a561c167485
1074,572,75,1957,430,3034,e7b7f94678c632791f0323f8c61ce611275605c5
1075,572,75,1957,430,3034,2dc9ec5616a942de3a0886a707f93988f56dd594
1077,572,75,1957,430,3034,ab26b65b2f178597be845e203eb698e193e3502e
1079,572,75,1957,430,3034,fe58d96e50e33b05f2a45f1493eca39ec9b3d030
1080,572,75,1957,430,3034,5528e7da1a790aae8f6e0fd61ebccb2b87cbd97a
1085,572,75,1957,430,3034,79c3f226dd6e6a4dd27173d08b024bf756ea6e39
1088,572,75,1957,430,3034,19f98946f2b31b62303aedb5b30951ca295116d8
1089,572,75,1957,430,3034,e23e7b2ffe8e282adfd5c597df25c181413c5b3b
1090,572,75,1950,437,3034,b929d2d09d24705bc59d1d172921e1feade2777b
1091,572,75,1950,437,3034,a7901c2e090d720ef0427552387be7f14cbe2ac6
1092,572,75,1950,437,3034,8e84d9c8440f571c0d11cd5d7c35dcedca46392c
1093,572,75,1950,437,3034,3c5862ccb0fc77418c3b20c21c6b57c40b483464
1094,572,75,1950,438,3035,f3dc173240d2a91c831b08dd6820e1d83322f3da
1095,572,75,1950,438,3035,29d52583e77b247aceeb2f514177a8a6c21ed786
1096,572,75,1949,439,3035,862de0b254bbb0ec75d637c7fbff258ecf232786
1098,572,75,1949,439,3035,617eff41acc583a3b0f97bb6bcc7efe096dc4891
1099,572,75,1949,439,3035,25c157e4ccc27702883b0c3a53e0e9b44e19757d
1100,573,75,1949,439,3036,1bbca7961cee20c4ddd453a7d74d316e84f4bbb5
1101,573,75,1949,439,3036,f2f8972def26cea2b0e8dbe763e11436d194e3d4
1102,573,75,1949,439,3036,dae81c6ec62a76c1f28745ae3642c2d4a37ce259
1103,573,75,1949,439,3036,4283a038431ef6428d086d4911179bd8eb8b2299
1104,573,75,1949,439,3036,eaa3c883450f3c7ea939992ed075257bbac3d8b2
1105,573,75,1949,439,3036,acb833081dd3abca3bc62753103690f23fb3f0ec
1119,573,77,1950,439,3039,39bb66baad1b98e0fa10d668a09154a0f5372b3d
1123,573,77,1951,439,3040,c97b755a1cdd7051270de6ac2605a8a1e87555fb
1124,573,77,1951,439,3040,968b02f8f0f5170d6ec69bca9d92b2c281417782
1126,573,77,1951,439,3040,0cc0e676c0060739a9bbbd3e42287de008f11f53
1127,573,77,1951,439,3040,dfced0921c11f4ab9df8b036761b8965595e4416
1129,573,77,1951,439,3040,b2f6e421a332ce45cf0f1f2f6bd5962765a013f1
1130,573,77,1950,440,3040,0c7c18cc9e80101c882749c99437ad700fde0ca0
1131,573,77,1950,440,3040,cf99bae53af2ed8f73622bc8a8ed0331c272fda3
1132,574,77,1950,440,3041,1d8eb0cae57731b481a88dca272b2cb0d645bd8e
1133,574,77,1945,445,3041,6e8ddbaa2563ad7b95f96fe757d08870d2312977
1135,574,77,1945,445,3041,e3720b990a33ae259da4b1f1f6069aa6bbc8c03d
1136,574,77,1945,445,3041,47016d4322574860f90431e1c87d19f7a1f778c6
1137,574,77,1945,445,3041,e7e8d30cae9457339eb49ae8584e82ff0a038e99
1138,574,77,1945,445,3041,ec704371e301c5450dd5fc012a30424a8f47b99b
1139,574,77,1945,445,3041,a3c01b0dd8060f00a5ffd2589a776b4f618af6d9
1140,574,77,1945,445,3041,f45ee1974696c8fc17ccfe12ef9e4188e29543a2
1142,574,77,1945,445,3041,84b0a8d2aad042fb573df5055b6153770d0929ac
1143,591,77,1945,451,3064,b1e33ceceda1e75ff68c7deed8f6659683a195d3
1144,591,77,1945,451,3064,f3e5a746469401a16939de0fc17fed584ced2118
1146,591,77,1945,451,3064,4d933ad4181a511f3ced98edba4e17aff054e0e2
1147,592,77,1945,451,3065,3fe3887a2ed94f7b15be769f6d81571031ec5627
1148,592,77,1945,451,3065,83ea3bc798a87098e6507450e7db610020eb215e
1149,592,77,1945,451,3065,64d7a553e1be20174b0aa2882111049abf392d4f
1153,593,77,1945,451,3066,b53b4d5c107dbd56386c599582f46c522877a651
1157,593,77,1945,451,3066,535809e12161d28dacaf5161436fc05a9bb064aa
1158,593,77,1945,451,3066,b0c56b895fd2694d7f5d4595bdbbc41916607f45
1159,593,77,1945,451,3066,0603f09318049e67320121ace035b7ab03f88ca3
1160,594,77,1945,451,3067,8550161e531a603d57723850fb09c4c9b7ca60b9
1161,594,77,1945,451,3067,da5747f8e460ea2a2d16f124463b3975ccfc0992
1162,594,77,1945,451,3067,7506616f164a0e2a63fd8bf5ca044ddb78f9b22a
1166,594,77,1947,452,3070,4f6a7663bcddffb114f2647f9928cbf1fdd8e4b5
1168,594,77,1948,452,3071,f33b3ebd5302fe5821dd796156b0be66c5aebec9
1169,595,76,1948,452,3071,b02f08e02c34bcf19444c15b54c5f64ddd4c9ef2
1170,595,76,1948,452,3071,d49667ef26c1fba0612151064d414854ae45a830
1172,595,76,1948,452,3071,4b9d063da05faa112577a4e3cefd020850a25e9e
1174,595,76,1948,452,3071,75ed5900321d170debef4ac452b8b3cf8a1c2384
1175,595,76,1948,452,3071,71ebcb85b931f43865df5b322b2cf06d3da23f69
1176,596,76,1948,453,3073,aac2a2d2ae2486342058db0c72ed7ba2c7c8eb1e
1177,597,76,1948,453,3074,d8d853378b3ff75c03d8bd91ea026d2b8c642b0f
1178,597,76,1948,453,3074,186eb21dc159807dba83148f7c9c50d470745708
1179,597,76,1948,453,3074,5aa55038ca9ac44b440b56d1fc4e79c876e51393
1180,597,76,1948,453,3074,43f2eb7ef327126271a8c70d6fde5713947150a5
1181,597,76,1948,453,3074,1a09b3c398b42800de864023dad872d83b196181
1182,597,76,1948,453,3074,a4b80e242162a7d6ac2337a2a621a82027c549b7
1183,597,76,1948,453,3074,c3904deb919823af577adf5d9d35e9c113eb8289
1184,597,76,1948,453,3074,95edabb45e016ed269f96acc03d4a2bfcecd6b71
1188,597,76,1948,453,3074,00adec6d5f266469bc62e7351d8e6b641872b47a
1190,597,76,1948,453,3074,f5a33e4840d3ad4d1199e99f5a17a9af1d2176f9
1192,597,76,1947,455,3075,534aaf56f4a8e261e111426b2a709e2f8816192f
1193,597,76,1946,456,3075,2f53d342f1ce2fb36cddbd90e24c4fda86389c27
1194,597,76,1946,456,3075,fe3fc5210f0bb334a679ed420152af1c862c0239
1195,599,76,1946,457,3078,fcf494b48fea7c0c55ea29721ba0b2d250351ff8
1197,599,76,1946,457,3078,65a1055a36318ff4e21ffeb7c3dd62fa81892269
1198,599,76,1946,457,3078,1335aa2fb9f590d786a5baee1b781377dc3a2ec8
1199,599,76,1946,457,3078,005c9fc45f99d03344fa9fae3dd984c2ab87f1ea
1204,600,76,1946,457,3079,91e9f1c972842284a94097e252307ce6ed1007a1
1207,600,76,1946,457,3079,85c52743f7b99ac6575d87080a9ffb7540acbf18
1208,600,76,1946,457,3079,392f64842f678b6e29a2e5fac65a586d9c9a57ff
1209,600,76,1946,457,3079,f2975c021d247bf8c6a5fc23988639c636da86f5
1210,600,76,1946,457,3079,94a36cfd8c66a6be9a1e001b29e4c55071f4e0de
1212,600,76,1946,457,3079,134ca4d438bd7cbe8f0f287a00d545f96fa04a01
1213,600,76,1946,457,3079,cb1e779ceb461fd1a5ad9e7659316ac4d3775a5f
1214,600,76,1946,457,3079,af95eee9fb70dae5b3b2ce8bc73c13fc1de239ff
1215,600,76,1946,457,3079,f06ce6053cae6a96ecce29ce2020789945757bf4
1216,600,76,1946,457,3079,0e723ead5289f64d6fd648104c2aa741394060de
1217,600,76,1946,457,3079,7cb3a488436e8e7d0249280e95ba2ee945c96c87
1218,600,76,1946,457,3079,6b37719616b77872f9498ca74022563c178031e6
1219,600,76,1946,457,3079,b1f60460661c8058c511bfb7364dca935c5951ed
1220,600,76,1946,457,3079,d0ed01cef0c5ebb7ea9a1fb36de823aa01428600
1222,600,76,1946,457,3079,de31423130912a012513aad93ec805f8e08a0d5e
1223,600,76,1946,457,3079,8e8c0792c07f6dfbee5115d29911191adee04f2e
1225,600,76,1946,457,3079,c9a02bc8f5114d95079f72dd22aaeec36899117e
1226,600,76,1946,457,3079,25cccca0a286585b9896546d57559e41b4e2ca16
1227,600,76,1946,457,3079,2634f606d55b63511ab1c50c4fad2d52fbda1b19
1231,600,77,1946,457,3080,4fd264b6f1737b0317fdd95b3d7ff3bba15ae6c3
1233,601,77,1946,457,3081,c64dd646f5b6955ca09e0509a6e2ffabfa97d935
1234,601,77,1946,457,3081,57039f9661d2fc06618bba1ed60d005212ee26e3
1235,604,77,1945,461,3087,3af9b70028487be81c4f6ca65ca0d1f2be337e4f
1236,605,76,1944,464,3089,04ee4059d71dbc6aa029907e251360eaf00e11bb
1237,605,76,1944,464,3089,27b2321793c62fb2cbb00fd2830c9387a187a84f
1238,605,76,1944,464,3089,9a3dfa2a524aedb8580b7311585f9d52f252f4e7
1240,607,74,1943,465,3089,a25d3ce007b90a0516aed54fc1c5a16510a290e4
1241,607,74,1943,465,3089,d79122f40ba2016b1a943e2e1ba46984b2ef99ad
1242,610,71,1943,466,3090,785cc71d5b3300e2702b0b2fc7316e58ca70b563
1243,610,71,1942,467,3090,222d0633010e2f37f9fbd2d0559ecc4a5643c738
1244,610,71,1942,467,3090,5c62887d82b1d886c97eb2d4ed3f596b0e6bfebb
1245,610,71,1941,468,3090,1392aff440bc8be26ac09062265269a0414d96d1
1246,610,71,1941,468,3090,3bbebd06adc36f31877a9c0af6c20c5b5a71a900
1247,611,70,1941,469,3091,6a70cb53971a19f2d9e71d5ee24bfb0e844b4d9d
1248,611,70,1941,469,3091,1bb6ecf6d3b31bd606754ddbd1398550f605d3e5
1249,611,70,1941,469,3091,7140d4adf724347aceda1cec7d194f0403fba027
1250,611,70,1940,470,3091,fd6a299cd06fac615ccb9006df0dd98cd8461cc5
1251,611,70,1940,470,3091,f1761e3fefadd9730e8b17c0995e1317c58bd10c
1252,611,70,1940,470,3091,96317ad8defa89a9a4e8ecf4e22e64cb0c3054d7
1253,611,70,1938,472,3091,e5c12f6701075fe9210c67cf472f910d745cb73a
1254,611,70,1938,472,3091,b6e6fcf326ff3b008ccd7e935c391432d95bc5e2
1255,611,70,1938,472,3091,6eed9ae747a0178de817da2e56bd09e73bee84ad
1256,611,70,1938,472,3091,b4002a214399d8619965f40e153ca3f7dcb20904
1258,611,70,1938,472,3091,b6ea1961eb6816dee4370fb0ebd49dba29478db1
1259,613,69,1937,473,3092,5d383549eee498e4903fe290613d726a68615aca
1260,614,69,1937,474,3094,849037af36000d53b0b3b52f780ff475534e195b
1261,614,69,1937,474,3094,491de4f07c5018aa6f409dbc9bcf32ff631d5f2e
1262,614,69,1937,474,3094,a3fe4addcb9063fc327c8609c7ebba4d531da4ce
1263,616,68,1937,474,3095,75374d3797c2cd2423982a870bb0bc74821e951f
1270,616,69,1941,474,3100,e6cfa08f2d478cb962528188dff5cf4daf5e5f9b
1272,617,68,1940,475,3100,2ccfac1a651ff35cd243cd272b2202ae1ccd5740
1277,617,70,1946,475,3108,a780505f3a3c41b691cf142379b192960c008b50
1278,617,70,1946,475,3108,fd1e54b923871d9596f9692c0fc576cd40ce3e38
1282,617,70,1946,475,3108,361f60479d1890e8144fc254d7389a67b35725e9
1283,617,70,1946,475,3108,a51070e7434426467869147608c5a8ca58e21e00
1284,617,70,1946,475,3108,7372cdebed19a9d8e5527823c1e6825156babf98
1285,617,70,1946,475,3108,53e89ce2e71411ff9d1c3fd6f2b10d052a4aeace
1286,618,69,1945,476,3108,afe777639cc1c591df32591e196d4cda5783c615
1288,618,69,1945,476,3108,de99f558d806a2a1b30072ec95bc44d412d80dab
1297,618,69,1947,476,3110,50acbf3ff6f7c8d18b435d37c476aa2136fdac86
1298,618,69,1947,476,3110,a3a6def867c61d24dfded6cbfef7f820409dc739
1300,618,69,1947,476,3110,b7ade645290ecf45530fe7211f8f759fc9cf9971
1301,618,69,1947,476,3110,4cd2bdae07ac5561fdae0eede58c68df4dfcc780
1304,618,70,1948,476,3112,53ccffdb8c8e47a4d4304df453d8c79a9be295ab
1305,618,70,1948,476,3112,6348db378a8fef555aba30761857ef161112b499
1306,618,70,1948,476,3112,a523d94b4581ec41c86f5bbaaffdf5bb6b819c2e
1308,618,70,1948,476,3112,8d1a001ef6dcbbe8053da05cdb3ec99965b0953f
1311,618,70,1948,476,3112,061801e3dfb3f88550cdaeef1a6dd1c24c13d53d
1314,618,70,1948,476,3112,9f6b704769ba5bc0daafc25340d3dc28b18d8fb1
1315,618,70,1948,476,3112,37a5a363215d7c0360ff0a8f57856d373e8c1629
1316,618,70,1948,476,3112,adcf823359d7402fc1f57a2e005cea52905d897d
1318,618,70,1948,476,3112,ac09d22f7913ff09f98001ff51b783932290e378
1319,618,70,1948,476,3112,58c7ff39fb265754fb17ab8d7f8a1401b355777b
1320,618,70,1948,476,3112,d2ef521a53e765585cb31a053e4b0158b5faefe6
1321,620,69,1948,477,3114,41ed6338a40240112f242d76970bfa473da2209f
1322,620,69,1948,477,3114,fa2e1e633ac2073906ed3f1f32107d02331107aa
1323,620,69,1948,478,3115,3f22e83e90bc2eeea5f65858660385a34fbf5486
1324,620,69,1948,478,3115,c055224763e11b29cce0a7c10751354c40dac63e
1325,620,69,1948,478,3115,35355a4ffedb2aeed52d5fe3034380ffc6a438db
1329,620,69,1948,478,3115,2b6344e9447b5a62cb779b92b061b783bdef5f1c
1330,620,69,1948,478,3115,04ecc26223e4c574067e827320a7f26a86477c88
1331,620,69,1948,478,3115,b215a3ab63d1c34746855594656e988561484fe3
1332,620,69,1947,479,3115,287532588941d2941e19c4cd069bcbd8af889203
1333,620,69,1947,479,3115,9f2881deb127593e8e0fa25e978aad9029d7b562
1334,620,69,1947,479,3115,6afa6818fcf25665bbf61f0921c8c8c6fa8f223e
1335,620,69,1947,479,3115,3543fec3b739864c52de0a116dde3b0e5e885799
1336,622,69,1947,480,3118,e0837f2cb12de5e95e621d19b186b0da43bcdee2
1337,622,69,1947,480,3118,cb15ceb5555de0799210a0ce37e744fd4f284b36
1338,622,69,1947,480,3118,3f766d44c5ea000ecf47829ca565b1921dab2ac1
1339,622,69,1947,480,3118,914167abf19d16ac97c0f1f6ae1b08cb377c8f3a
1340,622,69,1947,480,3118,1e8d48252b83efa31118be07b7e134cf0255237d
1343,622,69,1947,480,3118,ca43ee9d0f4682c989e6b88bbc97ddb706ecff0a
1344,622,69,1947,480,3118,7ce6b10e9464995a038289e00169ffa85d29e3a5
1345,622,69,1947,481,3119,25f287f6b2f677213605364c33bb37f33feac953
1346,622,69,1947,481,3119,4a7b58210defea33a428b748ccbc97ae8fd49838
1347,623,68,1947,481,3119,37d06cfc46679759c47178a3380b12fbf22a4f25
1348,623,68,1947,481,3119,5d8985005edd1f308e64b38741ff09a95bea7846
1349,623,68,1947,481,3119,384ddbec1b73a4636f234da3894fde8f8420bb63
1352,623,68,1951,481,3123,00db71d452d04e417bcc2a88757af1c9e22b8e74
1353,623,68,1951,481,3123,7a5b7e35bf2e219225b9f26d3dd3e34f26e83e9c
1357,623,68,1951,481,3123,67732a9b183d2e84c85147b04fdf9499f4395ac6
1358,623,68,1951,481,3123,617b1a21f5a661ef44030c1662440cc5be158ec0
1360,623,68,1951,481,3123,6c9f37ea9eafb0ca1b02eb71ae8d375672043824
1361,623,68,1951,481,3123,8bdfabed6563f2ae136ad43e05bb254c9c15811a
1362,624,68,1951,482,3125,211486f3ab5602cdc332f03cd03fad3cb929d154
1363,624,68,1951,482,3125,5b980897f2da3c048d88029af554e0fc4be68a8e
1364,624,68,1951,482,3125,a82e21b0f9ac613db3354d46539cb97c897ea663
1366,625,67,1951,482,3125,80dac8c33e7f6f22577e4346f44e4c5ee89b648c
1369,625,67,1951,482,3125,c7aff31397a7228f6ac2e33c10ebdf36c4b7a9b7
1370,625,67,1951,482,3125,b971c1cd78a0bf831c1c30080089c4a384d037a0
1372,625,67,1951,482,3125,4dcc2a195595f8d7ddad45bc4baf98ffdeec7f41
1373,625,67,1951,482,3125,c1b6a8a98b08fedfa3f3c69bc7add94c5841ba57
1374,625,67,1951,482,3125,a3fffdca2472885a99e1ea9159a685753cd45738
1375,625,67,1951,482,3125,0922bbf18d3ae8f37e1823df2dbc270d33334548
1376,625,67,1951,482,3125,6c95b134e9b2d5641c123551c080305e90e6a89d
1377,625,67,1951,482,3125,df0a446fd4c864c003e4f941b5b7abd6f10c9427
1378,628,67,1951,484,3130,6ff500127a21f5f2104dc77a09dfa73d5f7c94ce
1379,628,67,1951,484,3130,f59a0401e5d0e19568a038f2a50954d1a9a1526f
1380,628,67,1951,484,3130,aff4b75c34d62ec932414b5099016007fff17317
1381,629,66,1951,484,3130,3db3ab71e97d34260057a6f51d4b2f72da30dc8d
1382,629,66,1951,484,3130,63f0e2df2a3af7b7225150a4ba6d63985b405855
1384,629,66,1951,484,3130,4a50daf6b343db1b5c316aa29efd657e160d0cd3
1387,630,66,1951,484,3131,48888a1a67db0404e5a31c9ca0349984e496f26f
1388,630,66,1951,484,3131,a272db70085887209946f28c9407409bfc0c7ee1
1389,630,66,1951,485,3132,230d8c7301281176a31443a2f4f425828291e46d
1390,630,66,1951,485,3132,1745aa000a4e859c21270371662634978371dda8
1391,630,66,1951,485,3132,05248a1009c05985b1c227a1a48b871c3068cb12
1393,630,66,1950,486,3132,32cd7069711d2e02fcd20c005c59c175d542c62e
1395,631,66,1950,486,3133,12aeed8c949925488a36f0a3b3bf25dfc9407cbf
1396,631,66,1949,487,3133,80855a4b3787bace050a8b4a2b80f79306e69812
1397,633,65,1949,487,3134,0dbe897ab5ea055ed53a219f642348d98e1c3cf9
1398,634,65,1949,487,3135,0f6d51e6a0a22e37e45c4bf452ddb49723e2f956
1400,634,65,1949,487,3135,8b5acda8214c2b8fd73298e106d99627c5815d97
1401,634,65,1949,487,3135,ee66d8dd7df8326c453fd04c2bdeb5225df934be
1402,634,65,1949,487,3135,3f300efede9f9670f4c413ff85ad731def15992b
1403,634,65,1949,487,3135,59e85f09c6c8171d5b24290d455e351063d81f5a
1404,634,65,1949,487,3135,2b9eed41fa26537d1af4f818c6e4296ce3305b01
1405,635,65,1949,487,3136,c08f85fd547a3030cca7ac227e3378d70033e517
1408,635,65,1951,487,3138,89359347c4e7be123dd99d13a43d75e8610ae1dc
1410,635,65,1950,488,3138,494b7986a3e5996d857b085f188a630d1504d9ca
1411,635,65,1950,488,3138,10ace52a41fc3458fb7df51d11974b398f0fbde3
1413,635,65,1950,488,3138,310049a5ae2324788f5756b18aace648cc3c97de
1415,635,65,1950,488,3138,02ef96c5e58d8d3492b6e38246c8268f1a0de47e
1416,635,65,1950,488,3138,a7bb5af50be7b0efbb784011a41fd25fdfe4d42c
1417,635,65,1950,488,3138,3c7d2ee881b13c7fdd0aa90b0aba0430310786de
1424,635,65,1950,488,3138,34af2bc523321da828a02bcf8f225ec393ed75cf
1425,635,65,1950,488,3138,0b5d32facaa1badc0553934f6935507070cfea1b
1426,640,65,1949,490,3144,9c5e272860c076736237d4b280c7c922c46ba273
1427,641,64,1949,490,3144,1f07da3e29c7c3d47968e1c4531dd9bf902575b7
1428,642,64,1949,490,3145,5acf203db2e9562dbe4073bf85d5043ef3121ea9
1431,642,66,1949,490,3147,ea2f48ce8bd865874108af79766cdef2d197e540
1432,642,66,1949,491,3148,ce7dd1273e5ee3d927dbfda0b38aff2517fe004b
1434,642,66,1949,491,3148,976bd519a879b2fd7a356cb21bde32696adb545f
1435,642,66,1949,491,3148,32ef48aa562e6aaee9983f5d0f1c60f02fd555fb
1437,642,66,1949,491,3148,c4af8eb366be45420e13a400cc1dcc8fab91c1ad
1439,642,66,1949,491,3148,e5ab75d2fda8ef2617bc13074206e66c980ca51f
1440,642,66,1949,491,3148,48548d1a473a40adeaf292b63857efdd00a034be
1444,642,66,1949,491,3148,455034d4df048010de4ae0a9a2392b70d1463c61
1446,642,66,1949,491,3148,7521bb95d5caec35f7105fd2e0220c7666c1ecb3
1447,642,66,1949,491,3148,0bd067d0950f49ea586b9c2f0cc74fee24b1d3e9
1448,642,66,1949,491,3148,15ef1dd478c5b6f005e5f782b7619f718ed55e84
1449,642,66,1949,491,3148,96fe90f5356971e0e51a0bc41e045dde600d7521
1450,642,66,1949,491,3148,9dcfecb7c6c8285630ad271888a9ec4ba9140e3a
1451,643,65,1949,491,3148,7d81ee6efc385f7d4c1218639e4102c64495ba0f
1452,643,65,1949,491,3148,abf5ccc29c45d53ec17541179bb5f0a75b28915d
1453,643,65,1949,491,3148,8c5b8018f69226389a1373523c41cd37883c9556
1454,643,65,1949,491,3148,9ae8da0e3761c2823ca166336950fd3fef828a88
1455,643,65,1949,491,3148,69239c0f968ee55cb9ca1e31323fb696db0c2aec
1456,643,65,1949,491,3148,81b55fb90078788bfdc064550f2ff9da2c79d3b6
1457,643,65,1949,491,3148,e19bd086d608c981098130a49e406de91dcc3d26
1458,643,65,1949,491,3148,ab873e7a681e62d6803a3c04a051a47335f7b93a
1460,643,65,1949,491,3148,ad67fcdf51ebbbd7c02c1a2b1f269edc8f92afdc
1461,643,65,1949,491,3148,c7b8d5d135980b267b089b7367e1796304415417
1463,643,65,1949,491,3148,8ad923b9d06f173ff9c633af000a0b91063a5e12
1464,643,65,1948,492,3148,cdb17dcb64d141c5d1919888a32a6f3e3cd58616
1465,643,65,1948,492,3148,5ce84b8044b87b77eff329ed808e8be493a7cfe6
1466,643,65,1948,492,3148,06627ef2caa6854540b50b6f6309c7d12ccfb56a
1467,643,65,1946,494,3148,b78226cd3d2dd578ac57341e0c55754b31ab66ba
1468,643,65,1945,495,3148,7127eb287fb08b89a31bc97097a1fb6b08ada463
1469,644,64,1945,495,3148,03c6ad7ad44032206a8780f74c693d16ca1f1a37
1470,644,64,1945,495,3148,0a26121797b5e0aa07ada07fe1577a79d3853c40
1471,645,63,1945,495,3148,1b598b4b423f7f3b63d523a4cc1e42e5364dd415
1472,645,63,1945,495,3148,a449b7ef99efdbb5edc8b4aacc89eb6020145dd3
1474,645,63,1945,495,3148,3ee18400ae9b916da1a3bee9c9c630fd223a2d3c
1476,645,63,1945,495,3148,4373eac99828d99718a7b245d160e7e64fce2e95
1480,645,63,1945,495,3148,99c58c27d5a8e4a66230c413380508af223d12a8
1481,645,63,1945,495,3148,f98126a05aeb1671c8036900a2720e21645318ad
1482,645,63,1945,495,3148,5f7035cec7d5524d94539a2af5957107f6e0d86b
1483,645,63,1945,495,3148,ac750dbbc0533dcf9c2f6c0f09957adf6f976d3e
1487,645,63,1945,495,3148,81006b9657534a21c3eadb2bc4a87c46db54c099
1488,645,63,1945,495,3148,0115f9faa517bba882a31b0ade076601b5a41de6
1491,645,63,1946,495,3149,1679472165e840aef4c8c9ece2fbf4620b87beab
1492,646,63,1946,495,3150,1014ba026e879e56e0f265a8d9f54e6f39843348
1493,646,63,1946,495,3150,c6da4b0c687e9a0d1661e9a310f703b30c4a0988
1494,646,63,1946,495,3150,1155843a41af589a856efe8e671a796866430049
1495,646,63,1946,495,3150,1f29164ced01bde92c72d20d67bc453484a4f078
1496,646,63,1946,495,3150,7862cbda86cdbced5fbfe4f0056105e657c1f92c
1497,646,63,1946,495,3150,2085d8d5bc2625076983d3be14b30ea684c3f0d5
1499,646,63,1946,495,3150,dbbae2cead5ca1f15177415d4bfe795d4402be9f
1500,646,63,1946,495,3150,4608573788c04fc047da42b4b7b48fdee8136ad3
1501,646,63,1946,495,3150,e0de82c9b2c41c4c479d2245e7d5cd59638b5440
1503,646,63,1947,495,3151,d3e3703a15cd9d294406121bc43be0c75b1a4e0e
1504,646,63,1947,495,3151,34669ea6b88cefb6e6f7176c71b7947234fa50b4
1506,646,63,1947,496,3152,74365585e28174834184e659b788c917303cd98a
1507,646,63,1946,497,3152,4cd5d846d4a0a62bba6edf435a8ae9c6dcfacb43
1508,646,63,1946,497,3152,4a9c32f5eece9030c2b568e930cec0c1ba8f1da0
1509,646,63,1946,497,3152,cc8c02fa0fa2119704d1c39ca8509850aef84acc
1510,646,63,1946,497,3152,e171a83b1516a3a2a393a5300527af1aab21c213
1511,646,63,1946,497,3152,34bb6c0cb7b5b7b86390252389cc1b2b037d9ec6
1513,646,63,1946,497,3152,c550beb0ccc8855fde7ff50ada530f7ceff1a595
1514,646,63,1946,498,3153,8c553e7d3fd3f598a445f3c35711829e9b3645a4
1515,646,63,1946,498,3153,91a431f48c1fc5ecc9a837e8071a0062d31b490f
1516,647,63,1946,498,3154,9a2aca60304dc2e98f9ef45636e129d225cb981f
1517,647,63,1946,498,3154,9788625277b85596302bbf2c39cf829b7a766a4f
1519,647,63,1946,498,3154,19a5f6da329d58653bcda85f84efd5d5eaf68f84
1520,647,63,1946,498,3154,ce4914eab4688ace4b97d14a8c271887235ebb3f
1521,648,62,1946,499,3155,7624fdb9f8ea4cbff407436606998f572898038b
1522,648,62,1946,499,3155,815f4d206dfea41bdff167283c2cac43a71524ac
1523,648,62,1945,500,3155,2514e044a7fce58176c4e79eec298f3d8f70e89b
1527,648,62,1945,500,3155,abcdb237bb313d116ce2ac8e90f79f61429afc70
1528,648,62,1945,500,3155,ce737ac67845da9a73ad645d6b9fb1692390ad56
1531,648,62,1945,500,3155,263b3d2ba132ea443193dc0b728741317742c8d3
1534,648,62,1945,500,3155,406de4c243e3618c13c36c23e07a4aa33162b344
1535,648,62,1945,500,3155,2eefbca1a4140d8a8174a06a1f0160fcc76d8f64
1536,648,62,1945,500,3155,64240263f22055cb539159e9359e64d5096f39d9
1537,648,62,1945,500,3155,d95b22bd56764c71047ec16f628c00c0fd997cfd
1538,648,62,1945,500,3155,1c5f4e86bc9c7bae5d5f3830d9cfbb0043297261
1539,649,62,1944,501,3156,25b912abbe31fa440e702b5273c18cf74e2d6e0b
1540,649,62,1944,501,3156,1aba0e4c68111c99e15d9a4f4d7b4a0ec3c5da01
1542,649,62,1944,501,3156,7628f87e2b1ab4b8a881f06c8973be4c368aaa3d
1544,649,62,1944,501,3156,2c727101113770d41e0907b333568bc2c25435e0
1546,651,61,1941,507,3160,1f8dad69158a96d0649d321ce08ecc9c0465f962
1549,651,61,1941,507,3160,101dbeb673caf6b962e2e8fd09fe09dac26e9771
1550,652,61,1941,507,3161,e48a5b5a03181b3ada6183595eb6e1c599a9657a
1551,652,61,1941,507,3161,a80d70dd10f3c7d483579734e524c94c62832070
1555,652,61,1941,507,3161,5abed864ee1cd31a0b920768b4abe85b26b43a4d
1557,653,61,1941,507,3162,16945f0e9c57aeabadb6f2e2f150a2687455be40
1558,654,60,1941,508,3163,0a2d3b7387b815b4e5d5f3c026f8409fd2a7ff70
1559,654,60,1941,508,3163,d26207d56cab21e3767121d53ebaddbbfc78a4ce
1561,654,60,1941,508,3163,6258e163352690faf20bfc92c12468316d1a47ae
1562,654,60,1941,508,3163,0a19f8d4fc864de481eac1b76c799ffd6ced4e91
1565,654,61,1941,508,3164,5f7f3b46853c958789361a7defda8ca3c3c2be53
1566,654,61,1941,508,3164,b7177cc2a422a0183c8f2d56eceb6b9323c6f959
1567,655,60,1941,508,3164,7803f429a4d435623cb7b91dd324d3aadad87380
1568,655,60,1941,508,3164,7a452c5ce295679307bd81dd9b5f37b3cf762acf
1569,655,60,1941,508,3164,1e35dd1a053b620f065101c02069c8e142ebf8ec
1570,656,59,1941,508,3164,034dfbfc057b6090f9f2589731b8f58a70e4f885
1571,656,59,1941,508,3164,ad167502f36f2547718aee290d4d11bf7a26ff82
1572,656,59,1941,508,3164,5fa7b592b3f43282823045954c61a1f9a4b31a7f
1574,656,59,1941,508,3164,afd046396175416883cfb2b0202592f6081308ef
1575,656,59,1941,508,3164,58379d7e958fdf024f896b86f7df3415ce876200
1576,656,59,1941,508,3164,fa08d27fb714534670b431fde0cd04a17d637585
1577,656,59,1941,509,3165,4921d4e59f06c8add15a347c8b97b72b8d9baa74
1580,656,59,1941,509,3165,80bcbecd4a394f67c1679b077ba79a797c4a57d7
1581,656,59,1941,509,3165,db8763fb239137e9f750d26df221483a8ae5c97c
1583,656,59,1940,510,3165,998894e1b9f5a8715f4cac5f6201b5e9ac80510c
1585,656,59,1940,510,3165,8092745593e2aa7b54c6de44d12a893772ace3e9
1586,656,59,1940,510,3165,73a6ab6382809d5452907dcff5767403d8d66985
1587,657,58,1939,511,3165,ccc8f67b7760dd12faf6007f12a672a8e03f4d88
1588,657,58,1939,511,3165,54e2e688e1cfbdb37dfa5dd3b3ffdf2af12b4423
1589,657,58,1939,511,3165,68554d16761d1e3bb618686b6d66437c59940b47
1590,658,57,1939,511,3165,13dba4dba3ad52a8accee6778fb029fe81565d40
1591,658,57,1939,511,3165,550107ff756beeb17b465e98c26c59e3dcc5eb3e
1592,658,57,1939,511,3165,6ca163d7cc451fafd3015fa2ee735d5377fa3065
1593,658,57,1939,511,3165,6d03bc14e7b19ac5a818bc643189ff00b500b6d5
1595,658,57,1939,511,3165,e07def14b82b065f010a251cfbc8b3881f3c4d85
1597,658,57,1939,511,3165,97e1d2433085e01696dc2fac8bfbb9c421c82b67
1598,658,57,1939,511,3165,229fc793a027f1fd3e6e9d553ed09c15b521776c
1603,658,57,1939,511,3165,710e11d076b9e5ef3e3b486dfb70bb55b788691c
1604,658,57,1939,511,3165,316bc3fc9437c5960c24baceb93c73f1939711e4
1608,658,57,1939,511,3165,2cb50f935aa70e91dd6c2f253becd636a2eb6fb7
1609,658,57,1939,511,3165,8f5904560a7ab51d480410ca5228df1a28ec2295
1610,658,57,1939,511,3165,a3708fda3574a5a0d949000df1b03a54721cf029
1611,658,57,1939,511,3165,88fc9e2826044110b7b22577a227f122fe9c1fb5
1613,658,57,1939,511,3165,f920be7c329b3de77d1ea306a6104487ce1228fb
1614,659,56,1939,511,3165,2c0be9045bf883e20287ae04766098d7307b94ea
1616,659,56,1939,511,3165,cc2ca9c550fbf8fca8684b373a3c8e3618eea08e
1617,659,56,1939,511,3165,11f10b70f3cb21c7a7f859e417adee104758221b
1619,659,56,1939,513,3167,ff0dac96666e30a4252709b7d9f23b86635c2875
1620,659,56,1939,513,3167,8bc0266b3fca06ba2ff77f82c4243c96ff9e1f50
1623,659,56,1939,513,3167,ab33269b00858de7c37196a1ea044ce2080fd852
1624,659,56,1938,514,3167,34d88944f46d3e2734488fd0ca3c2c24c15a0264
1625,659,56,1938,514,3167,2084aed20c4d350a4192a0cfaa22140d4af3396c
1626,659,56,1938,514,3167,49f1cc54e6ce1147645372214c5b5a56c655da9e
1627,659,56,1938,515,3168,89b6856aa615bff5cccd1eeef61ab02d6e38498a
1630,659,56,1930,529,3174,7aabd6238028f4bb78d0687bbccc97bcf634e28b
1636,659,56,1932,529,3176,0825f77f7626d2ff175c17d06d726bf2f704f12c
1637,659,56,1932,529,3176,4d0f8831a7498ab3b1ebcf4cafa2ee234503e4f8
1638,659,56,1932,529,3176,b6dd0afead80a17d0ac8c3ba35c510afac32a0b8
1641,659,59,1937,529,3184,395af23ac1f3499b21eba5ca085200bfce251290
1642,659,59,1937,529,3184,c6ea4ed5d23671deee6e736fe1daba2c650a4fbb
1643,659,59,1937,529,3184,9f4e031bd3cb13d5879fe9ad3d889ce861b0babe
1644,659,59,1937,529,3184,b52b9cf6f2e88468b13ca64b806abc9a3dd437bd
1645,659,59,1937,530,3185,717a54c88307eabda9240cd28f0c7851f18b45eb
1646,659,59,1937,530,3185,7f663aeccf17a75d5fe3fee02d1ac577fdeb57f2
1647,659,59,1937,530,3185,0e7d59df3ed6988cd5a45e26414c013ad40c7402
1648,659,59,1937,530,3185,b61eab18f71f3afb36b3e8cb208a145046b3d8f6
1649,659,59,1937,530,3185,25f5b5c19dc23c6c09877c9c652a934e9669573d
1650,659,59,1937,530,3185,8e838d9c869083597dc9e161ae2fe37acaa90de9
1651,659,59,1937,530,3185,479ba5add23c119387baa60d5dce3a4e17d1b15b
1652,659,59,1937,530,3185,93be2f7dea51f7a063d9114660f5f1028a849cf0
1654,660,58,1937,532,3187,d638cdc42acec608c1967f44af6be32a477c239f
1655,660,58,1937,532,3187,f5af68ba68c1041d785e5582529134d54895e7c6
1656,660,58,1937,532,3187,6f229048ddd8c7347ff60dddfb9121e6021c7b2e
1657,660,58,1937,532,3187,285b08abc121fce878dbe536b0a68b421ec4300d
1659,660,58,1937,532,3187,59b57e672c2f5a685804cce253d2c5314c45c5fa
1660,660,58,1937,532,3187,a5619f7ed3bc2ca07b428fa0abfaaff088378f48
1662,660,58,1937,532,3187,a8614fb438432551e52a818b5f76f48d4ac5b499
1663,660,58,1937,532,3187,e6bd688ef3b58ee522794dce77f64a81b53b3b9e
1664,660,58,1937,532,3187,26c26e83081d68035d6411b1acc17ba033e1876d
1665,660,58,1937,532,3187,166e0490d39f619928ee9c5133cc5cab0ae5c1db
1666,660,58,1937,532,3187,d7a58f285b4c0c1b4ec032f9a7bf8f31913d0f5f
1667,660,58,1937,532,3187,82976e5c3f7abf20dfd4c3cc5aa586e57edef104
1669,663,58,1937,532,3190,cd40d9e721eb4f5d05f57a74c6f1fd5d4aaef444
1670,663,58,1937,532,3190,d508326e2f7d35973e2662109e34b425cb108b81
1673,663,58,1937,532,3190,542b7f6c50df18f2aa201cf1de81577c1bee643c
1674,663,58,1937,532,3190,179fbab7e05946b59ec9815d6e9b1901826ed610
1675,663,58,1937,532,3190,c8b3fbe21b09937b57e96dbddcc71946da246a2f
1676,663,58,1937,532,3190,071af825398bab08246aa28c227514ed37cf4244
1678,663,58,1937,532,3190,6be9589eb34f79914666c9d9e1e15bdb7fc44df2
1679,664,58,1935,536,3193,cf546e11ac76c8dec527e39ff8ce8249a195ab42
1680,664,58,1935,536,3193,3a36c8079544c83dcdea4e52181efcd2d1e86b9c
1682,664,58,1935,536,3193,8ab58b80529c5206654c1042a4ddcf2da364f8ec
1683,664,58,1935,536,3193,738bda8a6feea95d07b73246365e75b3d25e3466
1684,664,58,1935,536,3193,ffcdb0b471d0afc72b42b0a2b0c0c4fb45d7b6b1
1685,664,58,1935,536,3193,59f861fcb49a43acfbf2f75e683a7cb971600f52
1686,664,58,1935,536,3193,030ee15850182dc2db78c6250f5f5a19d1d2e0bc
1687,664,58,1935,536,3193,b0ad5081d51afa0a7ca71e865180d02f37fa2cca
1688,664,58,1935,536,3193,10427646b887586bf89dacb3b5208b3ad2d17308
1690,665,58,1934,537,3194,f7889b83b0e62f3dd7e16c0f54b03985de900ffb
1691,666,58,1934,537,3195,ed7b1bdf01330cde1c2da3af3451287fbe9304d9
1693,666,58,1934,542,3200,d693074d431c50e4801dd6bf52525ce1436358f0
1694,666,58,1934,543,3201,ed20dd2e85a0bbd45085809417c29e92ced5e618
1695,666,58,1934,543,3201,5005b527cb9c7a2bfc76daa7f717bf7e3064e9ce
1696,666,58,1934,543,3201,4cd24bb67c8d82630817e97ab9ba444ca955a94d
1697,666,58,1934,543,3201,cd0ba8053dfdc81ade9a656dc8049de600638501
1698,667,58,1934,543,3202,a6c803a2e3d270818d20f3f0c76e2241de9f0ab1
1699,667,58,1934,543,3202,5233b70070f8979f41ca1da2c1b1d78c8e30944e
1700,667,58,1934,543,3202,8035cee92293f3319919c8248c7787ba43c05917
1701,668,58,1934,543,3203,5146e2cf984a83c2eb9d8102ea73ee0792a9528b
1702,668,58,1934,543,3203,423b3afce431fd0a1d683bca9b2b80a1c4e3c8ca
1703,668,58,1934,543,3203,69b69f6d6085d80ccf36a3e999e9e5b98d580786
1704,668,58,1934,543,3203,3d2236773ba88e330841b8c72183b0e978e10909
1705,668,58,1933,544,3203,b7fdd60d85ee94df444369be1b2c778cda44a0c2
1706,668,58,1933,544,3203,c4e372aaf467ae41315cfe56a718a80469fc5318
1707,668,58,1933,544,3203,2ec23a3d41be2ba5df9f46b17e0a05eb1b051c41
1708,668,58,1933,544,3203,d91cc25a2a43cb2526943dc2285ffe59e38fabfd
1709,668,58,1933,544,3203,9af40f5df13801ffadcc5ded7440e4616123959f
1710,668,58,1933,545,3204,ed1bcf05158acf4bf4e0189d477b6c762bd0133e
1711,668,58,1933,545,3204,86eccdc8b67728d84440a46e5bf62c78f2eddf6d
1712,668,58,1933,545,3204,3738e4ac46688a0f13139c0b9058fc81c1aac424
1714,668,58,1933,545,3204,99a1265a394cb50f5b5aa9046f7b6cd230bc25cf
1715,668,58,1933,545,3204,cd3c042b0473e762b0e89bc69a9244c4a1fed66e
1716,669,57,1933,545,3204,c984e2bc15aa41de87404d6dd5d7e64f1a8e5038
1718,669,57,1933,545,3204,7a59910c377f87ae70754090d9561ace404ca7f5
1719,669,57,1933,545,3204,b26d147259202455ce356755b729c3dcb16ae9e6
1720,669,57,1933,545,3204,fa9ce4e9a691e4f8c8b093784bac752e488dc60b
1722,669,57,1933,545,3204,f18b08748abaecb171fdcbcdfdcd7e4d95d931d1
1724,669,57,1933,545,3204,63a6a653d4282f74e35582d41ca507139c9cfbe1
1725,669,57,1933,545,3204,5399ccc0f4257676981ef7937ea84be36f7058a6
1726,669,57,1933,545,3204,b10f66831ba2fc68901bc674104a76eb112ee52a
1727,670,57,1933,545,3205,f1628f6be1b8113b5e53aea497b2f6c47180e83f
1728,670,57,1933,545,3205,d52b0c5b38cce633a75420a703a15f03aabd70dd
1729,670,57,1933,545,3205,394e59099c89eb82cf4a37c78ab5f329b76ce0cc
1731,670,57,1933,545,3205,5d348bba3178f57bf018aee08d243a92933c5ce0
1732,670,57,1933,545,3205,0224f1cb042cc14545369b230cf7036af6c296ab
1733,670,57,1933,545,3205,77f50c9cfc8b33bf86394816cde183e656ba28cd
1735,672,56,1933,545,3206,312fc1af7b8a028611b45ee272652d59ea7bd85a
1736,672,56,1933,545,3206,edf3b88f1ad8f6e900fb3273cc8a573d3d77ce16
1737,672,56,1930,549,3207,4d83b0163e15f8352fd17fa121e929842ff2b686
1738,672,56,1930,549,3207,c70c5f04a41b7cb093e693f0ea226486fae27d22
1739,672,56,1930,549,3207,5081adcb9004f2c726dcfd054f7f16c5fd39d391
1740,672,56,1930,549,3207,32c7d93e5f0638c5a1ec8e2525c967be444fcef1
1741,672,56,1930,549,3207,28d05a4c195e2e01cdbc1435d58b44ece5ccc170
1743,672,56,1930,549,3207,8b6974a6857bdc48ad50bf21527b840c27648891
1744,672,56,1930,549,3207,a856555df2a1b4ddad8bf21243de0bcbcc12fb20
1746,672,56,1930,549,3207,483e0091e3891dc4ed898ea0dbf6923c166f0674
1747,672,56,1930,549,3207,a53175392ff753cc53a4a2d33a5852d113e67363
1748,672,56,1930,549,3207,692d05589061a593d4bfbdb2895eaef0386eca34
1750,673,56,1930,549,3208,2a7ce34600d0f879e93c9a5e02215948ed3bb6ac
1751,673,56,1930,549,3208,62ca2dea04489bdb23df1c7815439287c6d44630
1753,673,60,1930,549,3212,e3d782fe804a94b2fe7c8a18b95d9fb41fb9119c
1755,673,60,1930,549,3212,0d855990f76c3a072092cede74a816d79ab9e416
1756,673,60,1930,549,3212,35c41987ecfaad849019d09468ce322fec86cd39
1757,673,60,1930,549,3212,d9e150b3117521f7c24dc6393eb29eebc3cc376a
1758,673,60,1930,549,3212,ff19df9c2d6ad80bb9177e8190176e9c3716705f
1760,673,60,1930,549,3212,dbb0df2a0ec5bee80bee336fc81408efb30b7e47
1761,673,60,1930,549,3212,69208a5a1c55d42ca0eaffa900be643d9f801089
1763,673,60,1930,549,3212,4b2dcfe04f5d9938e40c569ffdd169f3a712145d
1764,673,60,1930,549,3212,e0f370364adc5d0dc3d7e4f678599c76868e29b0
1765,673,60,1930,549,3212,7bc94b58bf4e139b669d023e0fb10ce380fc89f6
1766,673,60,1930,549,3212,e429c5186ceed81c4627165518e0c70c58e69595
1767,673,60,1930,549,3212,e0519301238b43633bab64054772f9a62634a05f
1768,673,60,1930,549,3212,00cb9e13b4cf06ed2be27ee9e7fc18969ae69f7d
1769,673,60,1930,549,3212,6687f4dcbbfeca81b76233609fca90f30ce4dd25
1770,673,60,1930,549,3212,ee9f4686b19e2b4a68f5cb4f9d61dc045c1d4c63
1773,673,60,1930,549,3212,c87540cee5a3d5b676b9359c01bdea35f733aabb
1774,673,60,1930,549,3212,df3d5b1d73699b323aac377dffab039dca26c1e4
1775,678,59,1925,568,3230,16411b8400ad08f90c236bb2e18f65c655f903f8
1777,678,59,1925,568,3230,0db6367fe2aa6ab3fd152eacf172d57db45c1ffb
1778,678,59,1925,568,3230,f0ad641628a3ddc4e1c208e481b9cd0e9304dc3d
1779,678,59,1925,568,3230,3eba9638ee69138c73efb1d1c1d1b806ddafc6cf
1783,678,59,1925,568,3230,b551eda9c5670e70b8f4bc7569e46fc617d87ff8
1787,678,59,1925,568,3230,b07f91600d61a2f8d58adb4c92d36dd0b2b34fe7
1788,678,59,1925,568,3230,2c6c873e3fca6c0c54c2335e131f7742fcf2cf26
1789,678,59,1925,569,3231,d5b90c8e120687863c1d41cf92a4cdb11413ad7f
1790,678,59,1925,569,3231,186b6c61bfe85afa4d6bf213d04a28dd2853fed2
1791,678,59,1925,569,3231,49eeb0f570c91af5064d9e4ac8649e9afa0236ec
1795,678,59,1925,569,3231,62e83c71d2086b91d58c313e46933ef7aa8b6db1
1796,678,59,1925,569,3231,7cc2efc2d6916c05a0a5cb0c0e67f5405d8f6a03
1797,678,59,1925,569,3231,632a9f21bc1212559ba7b7eb298b1128d9f004de
1798,678,59,1925,569,3231,9f9921e89c5c559ff4324f8cf968007cefbf6442
1799,678,59,1925,569,3231,0cc32a8f9782f0e465b4653012de9bc41e6d7db4
1800,678,59,1925,569,3231,7f7553dd30534d606c84952a3f6dcb64b396ce37
1801,678,59,1925,569,3231,b2cddeaaf448234713f393749ceb1dbe22101f39
1802,678,59,1925,569,3231,7bb373e3097fe8e000e0bba005ff2dcfc18ab9a5
1804,681,58,1924,573,3236,a08fda2111d811aa53f11218fa03f3300dfff4cb
1806,681,58,1924,573,3236,7b8e4545c3521c6081db993ed2c14daa277d8dd9
1808,681,58,1924,573,3236,bd3c2900fc0e6863924d3b27f0713aa3022c061d
1809,681,58,1924,573,3236,b6433866682baac35a953e59298dff7f399ac49b
1810,681,58,1924,573,3236,b5f8c81ce18528ecf7cb4605dca864c961da9373
1811,681,58,1924,573,3236,44930cc4667268c20493d7e97387db2a97d61a26
1812,681,58,1924,573,3236,6ea7b6776c79b7a30b32c4f0c1f2658bc49dfe6c
1813,681,58,1924,573,3236,56c461a0d7c1cbb9d5709bda817579c7ee18d474
1814,681,58,1924,573,3236,7f218d98915ef3e76a98ef72075a6bde907dfe41
1815,681,58,1924,573,3236,59ef6559a31c175c1f52668ef0ffe9b8d87aa5a5
1816,681,58,1924,573,3236,db8f462494d603eba922818479a87f5ddfe1a13b
1817,681,58,1924,573,3236,822a03b3e41c7c26b7b623c782fbcf9e6eea863f
1818,681,58,1924,573,3236,ade54ffa34ddc6c19b26c6ea72b46f73af7b682b
1820,681,58,1924,573,3236,56aaae58a746eb39d5e92ba60f59f4c750a8e1a8
1821,682,58,1924,573,3237,cf7894be88f6c27680ef80796b883f6e3b709b8b
1823,682,58,1924,573,3237,ea7542891a4e3638a695c58bd6f00658b7c85985
1824,682,58,1924,573,3237,780bddf75b93784470a2e352ed44ee35a751d667
1825,682,58,1924,573,3237,cbaa3ee3ee45d453ab6aa36d57847515dd130b9f
1826,682,58,1924,573,3237,5052f79df45d843d1e44dcc47152ed503220098f
1827,682,58,1924,573,3237,c432dd40bde37667bfe6bb59eaff0a14c50cd27b
1831,682,58,1924,573,3237,3541ca1504d75b6b4fc8b8db0e7d62e990433f12
1832,682,58,1924,573,3237,4a03e6f27207ec7d9bb12d229da570633c086a92
1833,682,58,1923,574,3237,c8d970a548cb5cbdad80dbb1b5b4e44ff08662b5
1835,682,58,1923,574,3237,0bc5cd628042bf0a44df60a93085a4f991a84dfb
1836,682,58,1923,575,3238,3d6474e1a50dbaf9684f7fb34bfccb77630f27be
1838,682,58,1923,575,3238,bc7d201bdbaeac14a49f51a9ef292d6312b4c45e
1839,682,58,1923,575,3238,294d0d88158fa83eb095d663d054038ce9dfc3d4
1840,682,58,1923,575,3238,99d2469e75f1567cbe5ee753563edb68cd51d74a
1845,682,58,1923,575,3238,d45cfefbad4a6551cc40bf4c8c6d443da9a9d888
1846,682,58,1923,575,3238,cca151d196d520f799d3517a9719d03c0c8c9d8a
1849,682,59,1924,575,3240,21bf685f5e660a187fcac31e84d5cd89758aeb74
1850,682,59,1924,575,3240,28acc0d6df844ccfc8de6f4e7d5883eb4841e946
1851,682,59,1923,578,3242,5b94b17feff15a9f0345f92fc0568bfe7038e3a3
1853,683,58,1923,579,3243,e519aab43a419589e92fe284e4ce2f2e034aec6a
1854,683,58,1923,579,3243,ae9f08882fbff81726767e0dce9ea6e0e7d3eb41
1855,683,58,1923,579,3243,3486311a42728e0c9752bda16ac712797f5a6af9
1859,683,58,1923,579,3243,20e2b228aa87f2ce6341d5e96642c53b87a87459
1860,683,58,1923,579,3243,073dd4ce796441bf38388751817eb9f4c5514693
1862,683,58,1923,579,3243,2d28144c9519f4e4397c70f045c2b1d31437bf69
1863,683,58,1923,579,3243,ee596888e1149864e7828f5cf63c0eda395744c3
1864,683,58,1923,579,3243,f91b5a7e4b2ac436b1fe3065b23217543d0f54c1
1865,683,58,1923,579,3243,fb4272f0e6bbdaa3e19ed5fde59fdb5ab5a33baf
1866,683,58,1923,579,3243,9a33d3d76497d9e198de942ee1236c452231262f
1867,683,58,1923,582,3246,77974a684a2e874bccd8bd9e0939ddcb367a8ed2
1868,683,58,1923,582,3246,79d0a4fdb0d13ba6a843dace2b90ab44e856bd85
1869,688,56,1914,622,3280,bca9faae95db2a92e540fbd08505c134639916fe
1870,688,56,1914,622,3280,b49cc8664306f8b44e9e12ebb9e43791d508ec74
1872,688,56,1914,623,3281,16baec5c8a24ea4bf1bfc27a4c8fea7d0ff4860f
1873,688,56,1914,623,3281,a08d2463d2674b95f5a995f77cd9596168378a4f
1874,688,56,1914,623,3281,c00ae7f58c34962ed6dbec4eb8aaf747da59ed2f
1876,688,56,1914,623,3281,956cde800490d2d9e1e5fcc83755a9226de27f24
1877,689,56,1914,623,3282,0490d72f2a309ee2c6d73cdc5aa5cc381e14ae98
1882,689,56,1914,623,3282,104eddbdf6c31984b5afbdf5477267570de6d0f4
1883,690,56,1914,623,3283,002a4f72c46458514d97f7e54d4fd9416d89899d
1886,690,56,1914,623,3283,6b258befc2cd2e86281759e761979cbac4045e96
1887,691,55,1914,623,3283,49f4c9f4c61885189d136d7073c26ecc91b482b1
1888,691,55,1914,623,3283,729e0b086daac92bb9c6eb16f01cd2e13d258fdd
1891,691,55,1914,623,3283,b0b45f9a8373f47e96ef6c22d254c984d3b6b3c0
1892,691,55,1914,623,3283,497b5d6feee5b7947231bd0ae6edf833773b6cce
1893,691,55,1914,623,3283,5e8685c1b14e94e3f540ac1d68b61e71dcc27517
1894,691,55,1914,623,3283,65c13f9675d2ca7fc1c925e7182a2e35d07ff5fb
1896,691,55,1913,632,3291,abc0777b63057e2ff97eee2ff184356051e14c47
1897,693,54,1913,633,3293,60586dd7379b295b72d8af4e03423c286913b5e8
1899,693,54,1913,633,3293,229488c8a1486f25b1f2b5ca422cac67708c6c9d
1900,693,54,1913,633,3293,4dcaa5871b70859952c6f9c437dfe1b5f10509f2
1901,693,54,1913,633,3293,477274acb46b2f07666e9f84dea2e65ea6b63ad3
1902,693,54,1913,633,3293,cfda1fa3f8d95f0f4a369da9021dbd770e5fa44a
1903,693,54,1913,633,3293,13023ba86746980aace2341ba32a9419e7567751
1904,693,54,1913,633,3293,bdbe50a491ca41e7d4ebace47bfe8abe50a58211
1905,693,54,1913,633,3293,8e6a08e937272f088902cdbec65a9f2e919783bf
1906,693,54,1913,633,3293,31817dd2eb69db54eb559716aae42fe55ada5fea
1907,693,54,1913,633,3293,54236a2c1cda4666c164c7edbfb4396e2b01604a
1910,693,54,1913,633,3293,f05722a08a11b2e6c6c9acdf2bacd6a6128ccbb0
1911,693,54,1913,633,3293,5b2e11e574dcc84d3d10efa3ee45c25f97faca5e
1912,693,54,1913,633,3293,55481bcdeef43ef5e345f8ea3bae87f4a8ec7bb8
1913,693,54,1913,633,3293,e73fb2c9e1ecddf0016ea553350270c855d1de71
1914,693,54,1913,633,3293,5aa53286758fbb1fb864a5efda38718a2ca96759
1915,693,54,1913,633,3293,19d1cb14519186902d7e27813bf2643fe3f7cfa3
1916,693,54,1913,633,3293,4b0118465b485e068a8d9ead2384fcc2ac741f06
1917,693,54,1913,633,3293,04564eb74d2d92eaf88b22ab8cec7ef45978111e
1918,693,54,1913,633,3293,93897a6a75754c1c17d8a60dee188c86f13de232
1919,693,54,1913,633,3293,8dea9f089dcb8aea2c417c91344c4e680431e972
1921,708,50,1911,635,3304,3d0dcd7f5af378d3ab6adb303b913e6c7b2e0ee5
1922,708,50,1911,635,3304,253adc2b8a52982139d40c4f55b3fd446e1cb8f3
1923,708,50,1911,635,3304,26ad01719d73823e65c0358a2ee9941e0a888a63
1926,708,50,1911,635,3304,c47364ef0c368c9a0257dba68534d8781019cee4
1927,709,50,1911,635,3305,be9bd3348d3c4b060b6eea53ef23d0651c122c77
1928,709,50,1911,635,3305,9644e2e968b896f5400feb33d8d9bbdf5eea1e2d
1929,709,50,1911,635,3305,c79852acee9a2ca137ff0e19657342c7406bbbb9
1930,709,50,1911,635,3305,8bf8d0e0ecc1805480deb94feb4675b09d3b3a95
1931,710,49,1911,637,3307,a6ef025dfb2a1d1bd23893408eef6d066fb506d9
1933,710,49,1911,637,3307,62f3acc70a43a3c4f4970839d490ac8ea6c79047
1937,710,49,1911,637,3307,0fb1185538aeec9004fb9c84d96b81dc2778f66a
1938,710,49,1911,637,3307,731bdfe68ae8dd332702b1838db44f0efe433e2e
1939,710,49,1911,637,3307,917cc288a38f3c114a5440f0749b7e5e1086eb36
1942,710,49,1911,637,3307,1e9150443e5696d764ed81c97b53ef0365a5d854
1943,710,49,1911,637,3307,37f7ef41fbaebd5f545b99a11ab6036d92f9232b
1945,710,49,1911,637,3307,468d8211df999845607c3bb163c859e428d39dea
1946,710,49,1911,637,3307,926e90132dc15d76bb8d16e2f9f1279566cac3c3
1949,710,49,1911,637,3307,ad216381fcd7d3d62f1639f9998f5a965d8eaedb
1950,710,49,1911,637,3307,dcee1dfc798bbf4602a35fb73f6acade9f5fd630
1951,710,49,1911,637,3307,e972a7d03d81b2b336eb430a61d7215a3e6c4763
1954,714,48,1911,637,3310,6eb3ce11e4d6be237ad2e4895d8ae0b7bc1803dc
1956,714,48,1911,637,3310,0edb8a146fd6c60f4c3b1ad0a4a89963962f22af
1957,715,48,1911,637,3311,f91a04621ea8d7a657ff755645d823026257e898
1958,715,48,1911,637,3311,275314512d7dd10065026f02f61931e4c62c9cc8
1959,715,48,1910,638,3311,406675b1a03c0568f7768a73e7c279011e56054d
1961,716,48,1910,638,3312,015fad9060a8a6fb273a33b8e8457e504ed26131
1965,716,48,1910,638,3312,97eb3356b2a7488c8d0ca0e47ef3e538852d44a2
1967,716,48,1910,638,3312,10a162809fa4de3a56bb7f2d3cb12b6b82a6f826
1969,716,48,1910,638,3312,a325fb1f9b14b46288d0e1342407be4a6db2bdb1
1970,716,48,1910,638,3312,f0a84112ba1c9b253ebbcbd5d6942f01a7bee9d3
1972,716,48,1910,638,3312,7a7b82e6f4c34fbfd7a11123986ed74f9f752a48
1973,716,48,1910,638,3312,75143fa13f4f1ad2be84a103f7ce0eef9d06d3b4
1974,716,48,1910,638,3312,bb51dc902dc760b6fd03b860335fd99f47e2e13d
1975,716,48,1910,638,3312,f7a9872b914c8390eb1b5f5de9634160974b7d4f
1976,716,48,1910,638,3312,dca8b916ffa391964be26bbd62471d4c11b221fd
1977,716,48,1910,638,3312,6f1318734f0f3b6e62b782b0251a4e676e542e0b
1980,716,48,1910,638,3312,f2b45ddd99ff23c0bd103f1dda1e1cb0c8dc6d84
1983,716,49,1910,638,3313,353aecbf8c1a8cc6f3985149e2895d49e53dfc1c
1984,716,49,1910,638,3313,04e13c89138d48c20e774a2b6bf06796f73ac0fe
1985,716,49,1910,638,3313,46ecfb9b3a11a360724e3375ba78c33c46d6a992
1987,716,49,1910,638,3313,16a88b4429eb237cf3f7df6526c072efb72dbed1
1989,716,49,1910,638,3313,02430ef19d9a7d3663cbc1cf66438e9e86b919d1
1992,716,49,1910,638,3313,36f1f5cfb008c465f372389080cdd92671a6cab7
1994,716,50,1912,638,3316,50931dfa5310d5ae1c6e2852d05bf1e86700827f
1996,716,50,1912,638,3316,fcd08c175787e909b3eb98f756317a07741c48dd
1997,716,50,1912,638,3316,dec334cb66b3ee59cb82e1bb99a584aa0b9fbbd5
1998,716,50,1912,638,3316,b17a9150a0c3a132e82b53755ede62a45f897875
1999,716,50,1912,638,3316,1ac7fdcd136bbb7ae5476cb54f670be20178c4e2
2000,716,50,1912,638,3316,b59f963ad2a49322725b20fac71661bd49643443
2002,716,50,1912,638,3316,043383e3f31955c493517cb5b12dd538c02f5246
2003,716,50,1912,638,3316,11af73eaeb4371ded68460c1591abd6aefa57a90
2006,716,50,1912,638,3316,928c12eb1a75dbcab22b64f8cf0afb17389c20d2
2009,716,50,1912,639,3317,d4dc775620fc57e962165eab98a77264e3dd16b2
2010,716,50,1912,639,3317,f0425c72601f466c6a71518749c6d15b94945514
2011,716,50,1912,639,3317,88034c9938d92193d2104ecfe77999c69301dcc1
2012,716,50,1912,639,3317,fdccc02576ae5a524338f65e629948604d80b4c8
2014,716,50,1912,639,3317,70d3f81ca4ea7e1e1310e13ce0a633d7f920d45b
2016,716,50,1912,639,3317,d58aaa24e31f10e56a7f05a4451cd06a3cc6e65d
2017,716,50,1912,639,3317,b1afebf882db5296cd9dcea26ee66d5250922e53
2019,716,50,1911,642,3319,23e1ad537a5ce4b765f88ab5d2bfee06f773f8c9
2020,716,50,1911,642,3319,5c31d8d189ec24d83e25e2c560860f70307b431e
2021,716,50,1911,642,3319,375e1cfe2b2e1c3c57f882147c34902c6e8189ac
2022,716,50,1911,642,3319,032f5a789692d69ab206f902867ff2c3e05c5320
2023,716,50,1911,642,3319,6670da75ff8a59b2ec0b465846e3f76aab9155b2
2024,716,50,1911,642,3319,d43156e1e984d7e0848b7d4db218877a29d617b4
2026,716,50,1911,642,3319,33a4040d07ded45203b47cb2be9de69f9922b36c
2027,716,50,1911,642,3319,5a541e2e6cb01e254f20c302093a24d7dc9af8ce
2029,716,50,1911,642,3319,47b5a6a43c400619ca471de02e9f5fcc9f30d8bf
2030,716,50,1911,642,3319,b46c0ea6c87f006f9ef0ccc5d8c0fa2445fb4156
2031,716,50,1911,643,3320,269b5f262cef88cb595b21a76e707b41ee4ed627
2032,716,50,1911,643,3320,cdbd8745f6c550422170a6ae5928c0b679fab0df
2033,716,50,1911,645,3322,e81d1c995c0cc5573d3627de0fe6b803b2f43fb2
2035,716,50,1911,646,3323,706b33fef80b8b0901fdd2e954e5e5ea189a528a
2036,716,50,1911,647,3324,7f6fbc906a21e9f8db36e06ace2a9b687aa26130
2038,716,50,1911,647,3324,eda306f1cec20d490d5dc798ddaa8e8e8d13f26e
2039,717,50,1911,647,3325,1ff6e37de46f0cbf271a287a0ca67678e741a90a
2040,717,50,1911,647,3325,b41268135995cef46d40e550f9301fab20cf330d
2042,717,50,1911,647,3325,c5517b9e7439e542b381a0054bbdab9b5d2bc34b
2045,717,50,1911,647,3325,4c18a8a3788a4cd25b75ae342a7244c5f775b213
2046,717,50,1911,647,3325,10781b4c6ff981f581157957d221e7621e0bf4ed
2047,717,50,1911,647,3325,7a7e403325427642905a5b3e26931c2b8e92d4b1
2048,717,50,1911,647,3325,1f8cfcf3b41bac0ec862f171e2efb51b35324045
2049,718,49,1911,647,3325,fc584f06859b88474ea0db49bfe142e87428865d
2050,718,49,1911,647,3325,4b1529e2cbee697e7e772b05ad5038edef22f38d
2052,719,49,1911,647,3326,ee69789f4546cc07b4ea85d03eb5bb6261673198
2053,719,49,1911,647,3326,bbe136e1a2f9cbf3fd10d49fbe8558a5b394752c
2055,719,49,1911,647,3326,eb44172760e9439c8025d6812885b99a94892af3
2056,719,49,1911,647,3326,8890c533e0b53cb0021bd5faf15668430cd3075a
2058,719,49,1911,647,3326,65aa94200b3d10d515b15a78898c3692cd57e6c7
2060,719,49,1910,648,3326,766afc22a1dfa7d34a08de85356b7bc9dba025e7
2061,719,49,1910,648,3326,d5f89ff6e873dbb2890ed05ce2aeae628792c8f7
2062,719,49,1910,648,3326,ef33bc2d4d5e66b08cba2a318aa700ba1e28ba81
2064,719,49,1910,648,3326,3938b3ccaa85f1c366909a4839696007726a09da
2065,719,49,1910,648,3326,3389c5ea229884a1943873fe7e7ffc2800cefc22
2066,719,49,1910,648,3326,5e2c4d7afbaeec196aedb9888a47e0b635ff55d4
2067,719,49,1910,648,3326,5fb9756eba01237cc0e550da689b9b79c51c96ed
2068,720,48,1910,648,3326,b84f5ab4ec2d1edbe9a7effa9f75a3caa189bace
2069,720,48,1910,648,3326,3dd4e9203a64f99fdbe52f522619b98ec4a10a9f
2070,720,48,1910,648,3326,72e5778b23be7afec60658ebc48bb487e154fd37
2073,720,48,1910,648,3326,0223e213dd690b6b6e0669f836a20efb10998c83
2074,720,48,1910,648,3326,65bd053f11d22bca529f1da895599796fa0f3ee1
2076,720,48,1910,648,3326,a1b1688c7d6c1a6d307bd22669bd20f08e948f8d
2077,720,48,1910,648,3326,fe8ea3ba3ba709b3d6c39da046f0883a296e6441
2079,720,48,1910,648,3326,c5544d289233f501917e25970c03ed444abbd4f0
2080,720,48,1910,648,3326,67b46ba7016da2d259c1ecc7d666d11f5e1cfaab
2083,720,48,1910,648,3326,33db899a21387b8a00e881a06bd8e085482d30c2
2084,720,48,1910,648,3326,8c42cf0cbd87f344748423f235938dd6ade03f55
2087,721,47,1910,648,3326,60633ef3dec8421706c610d8238af2cd679fc915
2088,721,47,1910,648,3326,04240b23658f8935bbfebacccc23b5e47a1d6c22
2089,721,47,1910,648,3326,8ddc79a7991685b9463b4f4db43fc4c064bc49f8
2090,721,47,1910,648,3326,1d17bb4f7d78f6c3df9dedc0710acc5bdb300693
2091,721,47,1910,648,3326,5d240b070d744f9a2f4cc3117306ea861d866019
2092,721,47,1910,648,3326,c92123cc1dceeb800b3b8900e2e530ed19d78863
2093,721,47,1910,648,3326,2404d209a5e8c4573927e14587735562b79e13ed
2094,721,47,1910,648,3326,d0451e4cadf4277f117b9b581530c68d8dc43c6a
2097,721,47,1910,648,3326,c0181f2c1f982d27cdcea2ed293aa34a3ecf7d8b
2098,721,47,1910,648,3326,87994b40b3874e45666edfceb313e19611cd460e
2099,721,47,1910,648,3326,b886f166b332bda96b178a7327a5118f75d804b6
2100,721,47,1910,648,3326,de8a11ba18d5902c668d4db47c38c9c6bdf9c1da
2103,721,47,1910,648,3326,ada7a4aefb9bec4c34667b511022be6057102f98
2106,721,47,1910,648,3326,b388c294eb5745b3e01dedf0220636fae87ea9a2
2109,721,47,1910,648,3326,9ed4a788aa8d6ba6a57a2daa15253c3047048dfb
2111,721,47,1910,648,3326,4115288b4f7bbd694946a1ddef0f0ba85c03f9a1
2112,723,47,1910,648,3328,1845bc1d1007751a7f65c66aeddc35f032f6bf41
2113,723,47,1910,648,3328,359be4460e89e325fb2969b1f231c9507d1c116b
2114,723,47,1910,648,3328,2109975e901440da70e29d0f330a600bc2d37e9a
2115,723,47,1910,648,3328,95ca01f9995ef72c6bbe9bba477781b46cf573b4
2116,723,47,1910,648,3328,75614f6d4c1a3fe779a75eb3e787452cccd1d814
2117,723,47,1910,648,3328,4b129ac81f4fa38004950d0b307f81d1e9b44af8
2118,723,47,1910,648,3328,839a955d08fa0657622ed9b60fdd262658fa659f
2119,723,47,1910,648,3328,6c33e7333336487a30dbd170c93b2f6e50133de7
2120,723,47,1910,648,3328,74670498e902a0506e667cd21084c5e2eb71edfa
2121,724,46,1910,648,3328,b4250ea04a88f6c4fdf84dc8624baa1cf3e0f568
2122,724,46,1910,648,3328,96ec67a7cf89a136e793305343c5bba8521cdb47
2125,724,46,1911,648,3329,c5fda55edc13118c344cbf6e862a3a6a038e5578
2126,724,46,1911,649,3330,11c60b529816c5d29c3b4145055bf59b2e389de5
2127,724,46,1911,649,3330,ecbdedfc6948d6c08c18ce935b02406139310e7f
2129,724,46,1911,649,3330,593ecfe1352bce7daa7a2ca530a46de2f0133319
2132,724,46,1911,649,3330,602a38d87e4b0d9c5e43678c33208627ca84ce2a
2133,724,46,1911,649,3330,4323676ea5ab6994feb1385522665069d84f397b
2135,724,46,1911,649,3330,34c56687ae4df2cff632447eddd7ef255ee74726
2136,724,46,1911,649,3330,85a4844f8a8e628b90fa30ba7074f162a2d188ef
2137,724,46,1911,649,3330,4f0cd0fd162122da96978b357ac9fc9534529410
2138,725,45,1911,649,3330,1f035e6283dc06ad9ab719e786944a094c7eb330
2141,725,45,1911,649,3330,2495023a4cae28f494d0a6172abfac3a47a0b816
2142,725,45,1911,649,3330,ca5c05ddbe91f4aae38c4543240dbda5f1fb1db2
2143,725,45,1911,649,3330,b3610f38facb33704c1fd77590c6a2fa07c40fa7
2144,725,45,1911,649,3330,ab8af342b1d5dbe40502f1adfe8c7a6b746c8004
2145,725,45,1911,649,3330,91f87b8f91f5f8d01ac4b814dce218be27f56ab2
2147,725,45,1911,649,3330,5695c142d282f4681a8d43bb55ec49f11f3fc40e
2148,725,45,1911,649,3330,6aef986cdbff72809b39880132959ef74827492f
2150,725,45,1911,649,3330,204e00c0c57c34528157a739389b6935e4af2f36
2152,726,45,1911,649,3331,2f81f466a89ca07ee9860371b12d3c7376d9b615
2155,726,45,1911,649,3331,d0fe6c915665fa3220e84bd691ba7002a357e5c5
2156,726,45,1911,649,3331,1cb65b8a77bd1b15f094b5857468c107784aad90
2157,726,45,1911,649,3331,f8b23e52e86307428da2cf928bf4f1d9fdbd2694
2158,726,45,1911,649,3331,e7e5d9b338cabaafc61b7a0c55ff395b533d8c9e
2159,726,45,1911,649,3331,93a135d111c2569d88d65a3f4ad9e6d9ad291452
2160,726,45,1911,649,3331,44c0ecdd9226d039a8c666b36ae320af2046a1c1
2163,726,45,1911,649,3331,ecb59cc6579402b68ddfd4499bf30edacf5963be
2164,726,45,1911,649,3331,28bcff82c5ed4694f4761c303294ffafbd7096ce
2165,726,45,1911,649,3331,f15f4b8bb6f45dfdcb74f71e8dcc30c0aaa6ac80
2166,726,45,1911,649,3331,39a16dd2e003f9ca82a6d061a022ced6904bd243
2167,726,45,1911,649,3331,1d0abeaf757518808aabe9c85a2beaaa340fbc43
2169,727,44,1911,649,3331,983c158da7723eb00a376bd31db76709da4d0260
2171,727,44,1911,649,3331,4c1c93032f4a015cbb4b33958603d18ac43515b4
2172,727,44,1911,649,3331,53e8ab580f7c0fcfc589ba0b1b6cc2556080e0b2
2173,727,44,1911,649,3331,6dd503851c91197364f7c7b915cabb604fadb755
2175,727,44,1911,649,3331,efa9539787dbdd06cd2169023edcf7db3e2ff0c4
2176,727,44,1911,649,3331,abf07355aa5d85f4bb4dd9912d70fa62511fa40f
2177,727,44,1911,649,3331,49ac10b4de03279da9d67aeac5cb8561fc055085
2178,727,44,1911,649,3331,c41737dc00e2c8d34046b9f856f23fcc0cb4a82c
2180,727,44,1911,649,3331,baa8b0ec399bd9b0ff3308666b49c6ab734aa416
2181,727,44,1911,649,3331,5ca08f7cab4d65f9bd49bd8a1817dd4b6591cab1
2182,727,44,1911,649,3331,1243fdf5cb909a00b653dff5efb2e34d27c1cf7e
2183,727,44,1911,649,3331,157d7f1f1de4705daddebb77f21bd7097a74513d
2184,727,44,1911,649,3331,32c8e43ef1e859fa55af2f470a2a1120f51afabe
2186,727,44,1911,650,3332,e0a3d937309a82b8beea8f41b17d8b6298da2a86
2187,727,44,1911,650,3332,107165c4b04f4e5a830a60b6c66b2e5d8fb1d242
2188,727,44,1911,650,3332,9390da7fb6e251eaa9a785692f987296cb14523f
2189,727,44,1911,650,3332,a52a531a8b34f049fba11c3ee7b010af7534bf90
2190,727,44,1911,650,3332,14e6823d090a077d27f9f7caff2d505db31e55a7
2195,727,44,1911,650,3332,eaecada7934cef85ceede66b5322f31db5b84df9
2198,727,44,1911,650,3332,acfaec3db5ba39de52f6e607e74343dccf72fba1
2199,727,44,1911,650,3332,7b1ce7fd91091a55cad2fdafbe85e29c72522668
2200,728,43,1911,650,3332,2c125bded1834cadf3a6132d9ab87bc74f5ed728
2201,728,43,1911,650,3332,1a403aa705e7921eb6ec88c7d9f686ab0e54ef76
2207,728,43,1911,650,3332,0c0e8f0a62eb369bb05ff770ad53656831c8c01a
2208,728,43,1911,650,3332,67cf5efa31acb2916034afb15610b700695dfcb0
2210,728,43,1911,650,3332,a7c813ba045044ec23bb656ef9a23a0e38e36514
2211,728,43,1911,650,3332,f1db8c36e9178dcfa14a6bfcad48122a3a5ceea3
2212,728,43,1911,650,3332,53361589905c7c07692cd77f398ce6cb5ac39779
2213,728,43,1911,650,3332,03b6947728466e4e907487f30dd4dfec94a8eb2f
2214,728,43,1911,650,3332,870dd1d38b8f9238ddc917bbb55cee54ce37a0b2
2215,728,43,1911,650,3332,4b2cf1cd27587a30b3b081091627d7ee13141afe
2216,728,43,1911,650,3332,12ba20d83c8faa51823e1471ab35fb46688ca577
2217,728,43,1911,650,3332,940b7fd5cbcd743658f741d37b3d7b1766ed1f17
2218,728,43,1910,651,3332,edcecaf0dea718a8fb216df478df0d151a9ba04d
2220,728,43,1910,651,3332,49f95cc0a0167e91fd0f6987428905911bff076c
